border_size=1
usage=map

Gs, Gs, Gs, Gs, Gg, Gs, Gg, Gs, Gg, Gs, Gll, Gll^Fmf, Gll^Fmf, Gll^Fmf, Ch, Ds, Ds, Ww, Ds, Ds, Ds, Ds, Ds, Ds, Hhd^Fdf, Hhd^Fdf, Mm, Mm
Gs, Gs, Gg, Gg^Vc, Gg, Gg, Re^Gvs, Gg, Re^Gvs, Gg, Gg, Gll, Gll^Fmf, Gll^Fmf, Ds, Ds, Ds, Ww, Ds, Dd^Vhc, Ds, Ds, Rp, Cud, Cud, Mm, Mm, Mm
Gs, Gs, Gg, Gg, Gg^Fet, Gg, Re^Gvs, Re^Gvs, Re^Gvs, Gg, Gg, Gll, Gll, Gll^Fmf, Ds, Dd^Vht, Ds, Ww, Ch, Ds, Ch, Rp, Rp, Rp, Rp, Cud, Cud, Mm
Gg, Gg, Gg, Gg, Gg, Gg, Gg, Gg, Gg, Gg, Gg, Gg, Gg^Fet, Gll, Ds, Ds, Ds, Ww, Ch, 1 Kh, Ch, Rp, Rp, Rp, Rp, Rp, Cud, Mm
Gll, Gll, Gll, Gg, Gg^Fet, Gg, Gg, Gg, Gg, Gg^Vl, Gg, Gg, Gg, Gs, Ds, Ds, Rd, Ww^Bw/, Ww, Ch, Chr, Rp, Rp, Rp, Cud, Cud, Mm, Mm
Gll, Gll^Fmf, Gll^Fmf, Gg, Gg, Gg, Re^Gvs, Gg, Gg, Gg, Gg, Gg, Gg^Fet, Gs, Ch, Rd, Ds, Ds, Ww, Rp, Rp, Ch, Rp, Cud, Hhd^Fmf, Mm, Hhd^Fmf, Mm
Gll, Gll^Fmf, Gll, Gg, Gg, Gg, Re^Gvs, Re^Gvs, Re^Gvs, Gg, Gg, Gg, Gll, Gs, Gs, Ds, Ds, Dd^Vc, Ds, Ww, Ww, Rp, Ww, Gll^Fmf, Gll^Fmf, Hhd^Fmf, Gll^Fmf, Hhd^Fdf
Gs, Gll, Gs, Gg^Vc, Gg, Gg, Gg, Re^Gvs, Gg, Gg, Gll, Gll, Gll^Fmf, Gll, Gs, Gs, Gs, Ds, Wwf, Ww, Ds, Ww^Bw|, Ds, Ww, Ww, Ww, Ww, Gll^Fdf
Gs, Gs, Gs, Gs, Gs, Gg, Gll, Gll, Gll, Gll, Gll, Gll^Fmf, Hh^Vhc, Gll, Gll, Gs, Ww, Ww, Gll, Ch, Ds, Ds, Dd^Vht, Ds, Ds, Gll^Fmf, Gll^Fmf, Ww
Ww, Gs, Ww, Gs, Gs, Gs, Gll, Gll^Fmf, Gll^Fmf, Gll, Gll, Gll^Fmf, Hh^Fmf, Gll^Fmf, Gll^Fmf, Ww, Ww, Gs, Gll, Gll^Fmf, Gll^Fmf, Ds, Ds, Ds, Ds, Gll^Fmf, Gll^Fmf, Gll^Fdf
Ww, Ww, Ww, Ww, Gs, Gll, Gll^Fmf, Gll^Vhc, Gll^Fmf, Gll, Gll, Gll^Fmf, Gll, Gll^Fmf, Ww, Ww, Gs, Gs, Gg, Gll, Gll, Gll^Fmf, Gll^Fmf, Ds, Ch, Gll^Fmf, Gll^Fmf, Gll^Fdf
Gs, Gs, Ww, Ww, Ww, Ww, Ww, Gll^Fdf, Gll^Fmf, Gll, Gll, Gll, Gll^Fmf, Gll^Fmf, Gs^Ftr, Ww, Ww, Gs, Gg, Gg, Re^Gvs, Gll, Gll, Gll^Fmf, Gll, Gll^Fmf, Gll, Gll^Fdf
Gs, Gll^Ftr, Gll^Ftr, Ww, Gll^Ftr, Ww, Ww, Wwf, Gs, Gs, Gs, Gll^Fmf, Gs^Ftr, Ww, Ww, Ww, Gs, Gs, Gg, Re^Gvs, Re^Gvs, Gg, Gg, Gll, Gg, Gg, Gg, Gll
Gg, Gs, Gll^Ftr, Gll^Ftr, Gll^Ftr, Gll^Ftr, Ww, Ww, Ww, Ww, Ww, Ww, Ww, Ww, Gs, Ww, Gs, Gg, Gg^Vc, Gg, Gg, Gg, Re^Gvs, Re^Gvs, Gg, Gg, Gg, Gg
Gg, Gs, Gs, Gs, Ce, Gll^Ftr, Gll^Ftr, Ww, Ss, Ww, Ss, Ww, Gs, Ww, Gs, Gs, Ds, Gd, Gs, Gg, Gg, Gg, Gg, Gg, Gs, Gg^Fet, Gs, Gg
Gg, Gg, Gs, Ce, 2 Ke, Ce, Gll^Ftr, Gll^Ftr, Gg, Ss, Gs, Gs, Gd, Gs, Gd, Ds, Ds, Gd, Gd, Gs, Gg^Wm, Gg, Gs, Gd, Ds, Gd, Ds, Gg
Gg, Gs, Gs, Ce, Ce, Ce, Gg, Gg, Gg, Gg, Gg^Vc, Gs, Gd, Ds, Ds, Ds, Dd^Dc, Ds, Gd, Gs, Gs, Gg, Gd, Ds, Dd^Vht, Ds, Gd, Gg
Gg, Gg, Gs, Gs, Gs, Gs, Gg, Gs^Fp, Gs^Fp, Gg, Gg, Gs, Gd, Ds, Gd, Ds, Ds, Ds, Gd, Gs, Gs, Gd, Ds, Ds, Ds, Ds, Ds, Gg
Gg, Gg, Gg, Gg, Gg, Gg, Gg, Gs^Fp, Gg, Gg, Gg, Gs, Gs, Gd, Gd, Ds, Ds, Ds, Gd, Gs, Gs, Gd, Gd, Gd, Gd, Gd, Gd, Gg