border_size=1
usage=map

Gg, Gg, Gg, Gg, Gg^Efm, Gg, Gg, Gg, Re, Gg, Gg, Gg, Gg, Gg, Gs, Gs^Fp, Gs^Fp, Gs^Fmf, Gs^Fdf, Gs^Fdf, Gs^Fdf, Gs^Fdf, Gs^Fdf, Gs^Fdf, Gs^Fp, Gs^Fp, Gs^Fdf, Gs^Fdf, Gs^Fdf, Gs^Fdf, Gs^Fp, Gs^Fp, Gs^Fp
Gg, Gg^Fet, Gg, Gg^Efm, Gg^Efm, Gg, Gg, Re, Gg, Gs, Gg^Efm, Gg^Efm, Gg, Gg, Gg, Gs, Gg^Efm, Gs^Fet, Gs^Fp, Gs^Fmf, Gs^Fmf, Gs^Fmf, Gs^Fp, Gs^Fp, Gs^Fp, Gs^Fp, Gs^Fp, Gs^Fdf, Gs^Fmf, Gs^Fp, Gs^Fp, Gs^Fp, Gs^Fp
Ss, Gg, Gg, Gg^Efm, Gs, Gg, Re, Re, Gg, Gg^Efm, Gg^Efm, Gg, Gg, Gg, Gg, Gs^Fp, Gs^Fp, Gg^Ve, Gg^Efm, Gs^Fmf, Gs^Fp, Gs^Fp, Gs^Fp, Gs^Fp, Cv, Gs^Fp, Gs^Fp, Gs^Fdf, Gs^Fmf, Gs^Fdf, Gs^Fp, Gs^Fp, Gs^Fp
Ww, Ss, Ww, Gg, Ss, Gg, Re, Gg, Gg, Gg^Efm, Gg, Gg, Gg, Gg, Gg, Gs, Gs, Gs^Fp, Gg^Efm, Gs^Fmf, Cv, Gs^Fp, Gs^Fp, Cv, 2 Kv, Cv, Gs^Fp, Gs^Fp, Gs^Fdf, Gs^Fp, Gs^Fp, Gs^Fp, Gg
Ww, Ww, Ww, Ww, Ww, Ss, Ss^Bw|, Ss, Ss, Gg, Ds, Gg, Ds, Gg, Gg, Gg, Gg, Gs, Gs^Fp, Gs^Fp, Gs^Fp, Gs^Fp, Gs^Fp, Cv, Cv, Cv, Gs^Fp, Gs^Fp, Gs^Fdf, Gs^Fdf, Gs^Fmf, Gs^Fp, Gs^Fp
Wo, Wo, Wo, Ww, Wo, Ww, Ww^Bw|, Ww, Ww, Ss, Ww, Ds, Ds, Ds, Ds, Ds, Ds, Gs, Gs^Fp, Gs^Fp, Gg^Ve, Gs^Fmf, Gs^Fmf, Gs^Fp, Gs^Fp, Gs^Fp, Gs^Fp, Gs^Fdf, Gg^Ve, Gs^Fdf, Gs^Fmf, Gs^Fp, Gg
Ww, Wo, Ww, Wo, Wo, Wo, Wo^Bw|, Ww, Wo, Ww, Ww, Ww, Ww, Ds, Ww, Ds, Ds, Dd^Ftd, Ds, Gs^Fp, Gs^Fp, Gs^Fp, Gs^Fp, Gs^Fp, Gs^Fp, Gs^Fp, Gs^Fp, Gs^Fp, Gs^Fdf, Gs^Fdf, Gs^Fmf, Gs^Fp, Gs^Fp
Ss, Ww, Ww, Ww, Ww, Wo, Ww^Bw|, Wo, Wo, Wo, Wo, Ww, Ww, Ww, Ww, Ds, Ww, Dd^Ftd, Ds, Gs, Gs, Hh^Fp, Gs^Fp, Cv, Gs^Fp, Cv, Gs^Fp, Gs^Fp, Gs^Fdf, Gs^Fdf, Gs^Fmf, Gs^Fp, Gs^Fp
Gs, Ss, Ss, Ss, Ss, Ww, Ww^Bw|, Ww, Ww, Wo, Ww, Wo, Wo, Ww, Ww, Ww, Ww, Ds, Ds, Ds, Gs, Gs, Hh^Fp, Gs^Fp, Gg^Ve, Gs^Fp, Gs^Fp, Gs^Fp, Gs^Fmf, Gs^Fmf, Gg^Ve, Gs^Fp, Gs^Fp
Gs, Gs, Gs, Gs, Gs, Ss, Re, Ww, Ww, Ww, Ss, Ww, Ww, Wo, Wo, Ww, Ww, Ss, Ss, Ds, Ds, Gs, Gg, Gs^Fp, Gs^Fp, Gs^Fmf, Gs^Fp, Gs^Fp, Gs^Fdf, Gs^Fmf, Gs^Fp, Gg, Gs^Fp
Gs, Gs, Gs, Gs, Gs, Gs, Re, Gs, Gs, Gs, Ss, Ww, Ww, Wo, Wo, Ww, Ww, Ww, Ss, Dd^Ftd, Gs^Ft, Gs, Gs, Gg, Gs^Fp, Gs^Fmf, Gs^Fp, Gs^Fp, Gs^Fp, Gs^Fp, Gs^Fp, Gg, Gg
Hh^Fp, Gs, Hh^Fp, Gs, Gs, Re, Gs, Gs, Gs, Gs, Gs, Ss, Ww, Ww, Wo, Wo, Ww, Ww, Ww, Ss, Gs^Ft, Gs, Gs, Gg, Gs^Fp, Gs^Fp, Gs^Fp, Gs^Fp, Gs^Fp, Gg, Gg, Gs^Fp, Gg
Mm, Hh^Fp, Mm, Hh^Fp, Mm, Re, Hh^Fp, Hh^Fp, Hh^Fp, Gs, Gs, Ss, Ww, Ww, Ww, Wo, Wo, Ww, Ww, Ss, Gs, Gs, Ds, Gg, Gg, Gg, Gs^Fp, Gg^Ve, Gs^Fp, Gs^Fp, Gg, Gs^Fp, Gg
Mm, Mm, Ce, Ce, Ce, Hh^Fp, Mm, Mm, Mm, Hh^Fp, Ss, Ss, Ss, Ww, Ww, Wo, Wo, Ww, Ww, Ss, Ss, Ds, Ss, Gs, Gg, Gg, Gg, Gs^Fp, Gg^Efm, Gs^Fp, Gg, Gg, Gs^Fp
Mm, Mm, Ce, 3 Ke, Ce, Hh^Fp, Mm, Mm^Vhh, Mm, Hh^Fp, Ss, Ss, Ss, Ww, Ww, Wo, Wo, Ww, Ww, Ww, Ss, Ss, Gs, Gs, Gs, Gg, Gs^Fp, Gs^Fp, Gg, Gs^Fp, Gg, Gs^Fp, Gs^Fp
Mm, Mm, Mm, Ce, Mm, Mm, Mm^Xm, Mm, Mm, Mm, Hh^Fp, Hh^Fp, Gs, Gs, Ww, Ww, Wo, Wo, Ww, Ww, Ss, Ds, Gs, Gs^Vht, Gs, Gg, Gs^Fp, Cv, Cv, Gs^Fp, Gg, Gg, Gs^Fp
Mm, Mm, Mm, Mm, Mm, Mm^Xm, Mm, Mm, Mm, Ce, Mm, Hh^Fp, Gs, Ww, Ww, Wo, Wo, Ww, Ww, Ww, Ss, Gs^Ft, Ds, Gs, Gg, Gg, Gg, Ke, Dd^Vdt, Gs^Fp, Gg, Gs^Fp, Gs^Fp
Mm, Mm, Mm, Mm, Mm, Mm^Xm, Mm, Mm, Ce, Ke, Hh^Fp, Hh^Fp, Gs, Ss, Ww, Ww, Wo, Ww, Ww, Ss, Dd^Ftd, Ds, Ds, Gs, Ds, Gg, Gg, Gs^Fp, Cv, Gg, Gg, Gg, Gs^Fp
Mm, Mm, Mm, Mm, Mm^Xm, Mm^Xm, Mm, Mm, Mm, Mm, Hh^Fp, Ss, Ss, Ss, Ww, Wo, Wo, Ww, Ww, Ww, Ss, Ds, Gs, Gs, Ds, Gg, Gg, Gs^Fp, Gs^Fp, Gs^Fp, Gg, Gs^Fp, Gg
Mm, Mm, Mm^Xm, Mm^Xm, Mm, Mm^Xm, Mm^Xm, Mm, Mm^Xm, Mm^Xm, Hh^Fp, Ss, Ss, Ww, Ww, Ww, Wo, Wo, Ww, Ww, Ss, Gs, Gs, Ds, Dd^Vdt, Ds, Gg, Gs^Fp, Gg, Gs^Fp, Gg, Gs^Fp, Gs^Fp
Mm, Mm, Hh^Fp, Mm, Mm, Mm, Mm, Mm^Xm, Mm, Mm, Ss, Ss, Gs^Fp, Ss, Ww, Ww, Wo, Wo, Ww, Ww, Ss, Gs^Ft, Gs, Ds, Ds, Ds, Gg, Gg, Gg, Gg, Gg, Gg, Gg
Mm, Mm, Hh^Fp, Mm, Mm, Ha^Fma, Mm, Mm, Hh^Fp, Ss, Ss, Ss, Ss, Gs, Ww, Ww, Wo, Ww, Ww, Ss, Ss, Dd^Ftd, Dd^Ftd, Gs, Ds, Gs, Gg, Gg^Fp, Gg, Gg, Gg, Gs^Fp, Gs^Fp
Mm, Mm, Mm, Mm, Mm, Mm, Mm, Hh^Fp, Hh^Fp, Ss, Hh^Fp, Hh^Fp, Gs, Ss, Ss, Ww, Wo, Wo, Ww, Ww, Ww, Ss, Gs^Ft, Gs, Gs, Gs, Gs, Gg, Gg, Gg^Fp, Gg, Gg, Gs^Fp
Mm, Hh^Fp, Mm, Mm, Mm, Mm, Hh^Fp, Mm, Hh^Fp, Hh^Fp, Hh^Fp, Hh^Fp, Ss, Ss, Ww, Ww, Wo, Wo, Wo, Ww, Ww, Ss, Gs, Gs, Gs, Ds, Ds, Ds, Ds, Gg, Gg, Gs^Fp, Gg
Mm, Mm, Mm, Hh^Fp, Mm, Mm, Hh^Fp, Hh^Fp, Ss, Hh^Fp, Ss, Ss, Ss, Ss, Ss, Ww, Ww, Wo, Wo, Ww, Ww^Bw/, Ss^Bw/, Ss, Gs, Gs, Ds, Ds, Dd^Vht, Ds, Gg, Gg, Gg, Gg
Mm, Mm, Hh^Fp, Mm, Hh^Fp, Hh^Fp, Gs, Gs, Gs, Ss, Gs, Gs, Gs, Gs, Ss, Ww, Ww, Wo, Wo^Bw/, Wo^Bw/, Ww, Ww, Ww, Ss, Ss, Gs, Ds, Ds, Gg, Ds, Gg, Gs^Fp, Gs^Fp
Mm, Mm, Hh^Fp, Hh^Fp, Gg, Gg, Gg, Gg, Gs, Gs, Gs, Gs, Gg, Gs, Gs, Wwf, Ww^Bw/, Ww^Bw/, Wo, Wo, Wo, Ww, Ww, Ss, Ss, Gs, Ds, Ds, Gg, Gg, Gg, Gs^Fp, Gg
Mm, Mm, Mm, Hh^Fp, Hh^Fp, Gg, Gg, Gg, Gg, Gg, Gg, 1 Gg, Gg, Gs, Gs, Gs, Wwf, Ww, Ww, Wo, Wo, Ww, Ww, Ww, Ss, Gs, Ds, Gg, Gs^Fp, Gs^Fp, Gg, Gg, Gg
Hh^Fp, Hh^Fp, Hh^Fp, Hh^Fp, Gg, Gg, Gg, Gg, Gg, Gg, Gs, Gg, Gg, Gg, Gs, Gs, Ss, Ss, Ww, Ww, Wo, Wo, Ww, Ww, Ww, Ss, Dd^Ftd, Gg, Gs^Fp, Gs^Fp, Gs^Fp, Gs^Fp, Gs^Fp
Gg, Hh^Fp, Gg, Gg, Gg, Gg, Ds, Ds, Gg, Gs, Gs, Gg, Gg, Ds, Ds, Gs, Gs, Gs^Ft, Ss, Ww, Ww, Wo, Wo, Ww, Ww, Ss, Ss, Gg, Gs^Fp, Gs^Fp, Gs^Fp, Gs^Fmf, Gs^Fmf
Gg, Gg, Gg, Gg, Gg, Ds, Ds, Ds, Gg, Gg, Gs, Gs^Vht, Gg, Gg, Ds, Ds, Gs, Ss, Gs^Ft, Ww, Ww, Ww, Ww, Wo, Ww, Ww, Ww, Gg, Gg, Gs^Fp, Gg, Gs^Fp, Gs^Fp
Gg, Gg, Gg, Gg, Gg, Gg, Gg, Gg, Gg, Gg, Gg, Gg, Gg, Gg, Gg, Gs, Gs, Ss, Ss, Ss, Ss, Ww, Wo, Wo, Wo, Ww, Wo, Ww, Ww, Gg, Ss, Gg, Gg