border_size=1
usage=map

Ww, Gg, Gg^Efm, Gg, Gg^Efm, Gg^Efm, Gg^Efm, Gg, Gg^Efm, Gg, Gg^Efmy, Gg, Gg^Efm, Gg, Gs, Gs^Fp, Gs^Fp, Hh^Fp, Hh^Fp, Hh^Fp, Hh^Fp, Hh^Fp, Hh^Fp, Hh^Fp, Gs^Fp, Gs^Fp, Hh^Fp, Ha^Fp, Ha^Fp, Ha^Fp, Gs^Fp, Gs^Fp, Gs^Fp, Gg
Ww, Ww, Gg, Gg^Fet, Gg^Efm, Gg^Efm, Gg^Efm, Gg^Efm, Gg^Efm, Gg^Efmy, Gg^Efm, Gg^Efm, Gg^Efm, Gg^Efm, Gg, Gs, Gg^Efm, Gg, Gs^Fp, Gg^Fet, Hh^Fp, Hh^Fp, Gs^Fp, Gs^Fp, Aa^Fp, Gs^Fp, Gs^Fp, Hh^Fp, Ha^Fp, Gs^Fp, Gs^Fp, Gs^Fp, Aa^Fp, Aa^Fp
Ww, Ww, Ww, Gg, Gg, Gg^Efm, Gg, Gg^Efm, Gg^Efm, Gg^Efm, Gg^Efm, Gg^Efm, Gg, Gg, Gg, Gs^Fp, Gs^Fp, Gg^Ve, Gg^Efm, Hh^Fp, Gs^Fp, Gs^Fp, Gs^Fp, Aa^Fp, Ha^Fp, Aa^Fp, Gs^Fp, Hh^Fp, Hh^Fp, Hh^Fp, Gs^Fp, Gs^Fp, Aa^Fp, Aa^Fp
Wo, Ww, Ww, Gg, Gg, Gg, Gg, Gg, Gg, Gg, Gg, Gg, Gs, Gg, Gs, Gs, Gs, Gs^Fp, Gg^Efm, Hh^Fp, Hh^Fp, Gs^Fp, Gs^Fp, Ha^Fp, Ha^Fp, Ha^Fp, Gs^Fp, Gs^Fp, Hh^Fp, Gs^Fp, Aa^Fp, Gs^Fp, Gg, Gg^Fp
Ww, Ww, Ww, Ww, Gs, Gs, Gs, Gg, Gs, Gs, Gs, Gs, Gs, Gs, Gs, Gs, Gs, Gs, Gg, Gs^Fp, Gs^Fp, Gs^Fp, Gs^Fp, Hh^Fp, Hh^Fp, Ha^Fp, Gs^Fp, Gs^Fp, Hh^Fp, Hh^Fp, Ha^Fp, Gs^Fp, Gs^Fp, Gg
Wo, Ww, Ww, Ww, Gs, Gs, Gs, Gs, Gs, Gs, Hh, Hh, Gs, Gs, Gd, Gd, Gd, Gs, Gs, Gs^Fp, Gg, Hh^Fp, Hh^Fp, Gs^Fp, Gs^Fp, Gs^Fp, Gs^Fp, Hh^Fp, Gg, Ha^Fp, Ha^Fp, Gs^Fp, Gg, Gg
Wo, Wo, Ww, Ww, Ww, Gs, Gs, Gs, Gs, Gs, Hh^Es, Hh, Gd, Gd, Gd, Gd, Gd, Gd, Gd, Gg, Gs^Fp, Gs^Fp, Gs^Fp, Gs^Fp, Gs^Fp, Gs^Fp, Gs^Fp, Gg^Ve, Hh^Fp, Hh^Fp, Ha^Fp, Gs^Fp, Gs^Fp, Gg
Wo, Wo, Wo, Ww, Ww, Ww^Bw|r, Ww, Gs, Dd, Dd^Es, Dd^Es, Dd^Es, Dd^Es, Dd^Es, Dd, Gd, Gd, Gd, Gd, Gs, Gs, Hh^Fp, Gg, Hh^Fp, Gs^Fp, Ha^Fpa, Gs^Fp, Gs^Fp, Ha^Fp, Ha^Fp, Hh^Fp, Gs^Fp, Gs^Fp, Aa^Fp
Ww, Wo, Wo, Ww, Ww, Ww^Bw|r, Ww, Dd, Dd, Ds, Dd, Dd^Vhs, Dd, Dd^Es, Gd, Gd, Gs, Gd, Gs, Gd, Gs, Gs, Gg, Gg, Gg^Ve, Gg, Gs^Fp, Gs^Fp, Ha^Fp, Ha^Fp, Gg^Ve, Gs^Fp, Gs^Fp, Aa^Fp
Ww, Wo, Wo, Wo, Ww, Ww^Bw|r, Ww, Ww, Ww, Ww, Dd, Dd, Dd^Ftd, Dd, Gd, Gs, Ss, Gs, Ss, Gs, Gd, Gs, Gg, Gg, Gs^Fp, Hh^Fp, Gs^Fp, Gs^Fp, Hh^Fp, Hh^Fp, Gs^Fp, Gg, Gs^Fp, Gg
Ww, Ww, Ww, Wo, Wo, Ww^Bw|r, Ww, Ww, Ww, Ww, Ww, Dd, Dd, Dd, Dd, Gs, Gs, Ss, Ss, Gs, Gs^Ft, Gs, Gs, Gg, Gs^Fp, Hh^Fp, Gs^Fp, Gs^Fp, Gs^Fp, Gs^Fp, Gs^Fp, Gg, Gg, Gg
Gs, Ww, Ww, Wo, Wo, Wo^Bw|r, Wo, Ww, Ww, Ww, Ww, Ww, Dd, Dd^Ftd, Dd, Gd, Gs, Ss, Gs, Ss, Gs^Ft, Gs, Gs, Gg, Gs, Ss, Gs^Fp, Gs^Fp, Gs^Fp, Gg, Gg, Gs^Fp, Gg, Gg
Gs, Ww, Ww, Ww, Ww, Wo^Bw|r, Wo, Wo, Wo, Ww, Ww, Ww, Ww, Dd, Gd, Gd, Gs, Ss, Ss, Gs, Gs, Gs, Ss, Gs, Gg, Gg, Gs^Fp, Gg^Ve, Gs^Fp, Gs^Fp, Gg, Gs^Fp, Gg, Gg
Gs, Gs, Gs, Ww, Ww, Ww^Bw|r, Ww, Wo, Wo, Wo, Wo, Ww, Ww, Ww, Ww, Gs, Ss, Ss, Gs, Gs, Gs, Ss, Gs^Ft, Ss, Gg, Gg, Gg, Gs^Fp, Gg^Efm, Gs^Fp, Gg, Gg, Gs^Fp, Gg
Gs, Gs, Gs, Ww, Gs, Ww^Bw|r, Ww, Ww, Ww, Wo, Wo, Wo, Ww, Ww, Ww, Ww, Ww, Ss, Ss, Ss, Ss, Ss, Gs, Gs, Gs^Es, Gg, Gg, Gg, Gg, Gg, Gg, Gs^Fp, Gs^Fp, Aa^Fp
Gs^Es, Gs^Es, Gs, Gs, Gs, Gs, Gs, Ww, Ww, Ww, Wo, Wo, Wo, Ww, Ww, Ww, Ww, Ww, Ss, Ss, Gs^Ft, Gs, Gs^Vhs, Gs, Gs, Gg, Gs^Fp, Cv, Cv, Gs^Fp, Gg, Gg, Aa^Fp, Aa^Fp
Gs, Gs^Es, Gs^Es, Gs, Gd, Gs, Gs, Ss, Ww, Ww, Ww, Wo, Wo, Ww, Wo, Ww, Ww, Ww, Ss, Ss, Gs, Gs, Gs, Gs, Gg, Gg, Gg, Ke, Gg^Ve, Gs^Fp, Gg, Gs^Fp, Gs^Fp, Gg
Gs, Gs, Gs, Gs, Gd, Gd^Es, Dd^Es, Gs, Gs, Ww, Ww, Ww, Ww, Wo, Wo, Wo, Ww, Ww, Ww, Ss, Gs, Gs, Gs, Gs, Dd^Es, Gg, Gg, Gs^Fp, Cv, Gg, Gg, Gg, Gs^Fp, Gg^Fp
Hh^Fp, Gs^Es, Gs, Gd^Es, Gd, Dd^Es, Dd, Dd, Dd, Gs, Ww, Ww, Ww, Ww, Wo, Wo, Ww, Ww, Ww, Ss, Ss, Gs, Gs, Gs^Es, Dd, Gg, Gg, Gs^Fp, Gs^Fp, Gs^Fp, Gg, Gs^Fp, Gg, Gg
Hh^Fp, Gs^Es, Hh, Gs^Es, Gs, Hh^Es, Hh, Dd, Gs, Gs, Ss, Ww, Ww, Ww, Ww, Wo, Ww, Ww, Ww, Ww, Ss, Gs, Gs, Dd, Dd^Vhs, Dd, Gg, Gs^Fp, Gg, Gs^Fp, Gg, Aa^Fp, Aa^Fp, Gg
Hh^Fp, Hh, Hh^Es, Gs^Es, Sm, Gs, Gs, Gs, Gs^Efm, Gs, Gs, Ww, Ww, Ww, Ww, Wo, Wo, Ww, Ww, Ww, Ss, Ss, Gs, Dd, Dd, Dd, Gg, Gg, Gg, Gg, Gg, Gg, Gg, Gg
Hh^Fp, Mm, Hh, Sm, Sm, Hh^Fp, Hh^Fp, Gs^Vhs, Gs^Efm, Gs^Efm, Gs, Gs, Ww, Ww, Ww, Wo, Wo, Ww, Ww, Ww, Ww, Ss, Ss, Gs, Dd^Es, Gs, Gg, Gg^Fp, Gg, Gg, Gg, Gs^Fp, Gs^Fp, Gg
Hh^Fp, Hh, Hh^Fp, Hh^Es, Hh, Hh^Fp, Hh^Fp, Hh^Fp, Gs^Efm, Gs^Efm, Gs, Gs, Ww, Ww, Ww, Wo, Wo, Wo, Ww, Ww, Ww, Ww, Ww, Gs, Gs, Gs^Es, Gs, Gg, Gg, Gg^Fp, Gg, Gg, Gs^Fp, Gg^Fp
Hh^Fp, Hh, Hh^Fp, Hh^Fp, Mm, Hh^Fp, Hh^Fp, Gs^Efm, Gs^Efmy, Gs^Efm, Gs, Gs, Ww, Ww, Ww, Ww, Wo, Wo, Wo, Ww, Ww, Ww, Ww^Bw/, Gs, Gs, Dd^Es, Dd, Dd, Dd, Gg, Gg, Gs^Fp, Gg, Gg
Hh^Fp, Mm, Mm, Mm, Mm, Hh^Fp, Hh^Fp, Gs^Efm, Gs^Efmy, Gs^Efm, Gs, Gs, Ss, Ww, Ww, Ww, Ww, Wo, Wo, Ww, Ww^Bw/, Ww^Bw/, Ww, Ww, Gs, Dd, Dd, Dd^Ftd, Dd, Gg, Gg, Gg, Gg, Gg
Hh^Fp, Mm, Mm, Mm, Hh^Fp, Hh^Fp, Gs, Gs, Gs^Efm, Gs^Efm, Gs, Gs, Gs, Ss, Ss, Ww, Ww, Ww, Wo^Bw/, Wo^Bw/, Ww, Ww, Ww, Ww, Ss, Gs, Dd^Es, Dd, Gg^Vhs, Dd, Gg, Gs^Fp, Gs^Fp, Gg
Hh^Fp, Hh^Fp, Hh^Fp, Hh^Fp, Gs, Gs, Gs^Es, Gs, Gs, Gs, Gs, Gs, Gg, Gs, Gs, Wwf, Ww^Bw/, Ww^Bw/, Ww, Wo, Wo, Ww, Ww, Ww, Ss, Gs, Gs, Dd, Gg, Gg, Gg, Gs^Fp, Gg, Gg
Gs, Hh^Fp, Hh^Fp, Hh^Fp, Hh, Gs, Gs, Gs, Gs, Ss, Gg, 1 Gg, Gg, Gs, Gs, Wwf^Bw/, Wwf, Ww, Ww, Wo, Wo, Ww, Ww, Ww, Ss, Gs, Gs, Gg, Gs^Fp, Gs^Fp, Gg, Gg, Gg, Gg
Gs, Hh^Fp, Hh, Hh, Gs, Gs, Gd, Gd, Gd, Gs, Gs, Gg, Gs, Gs, Gs, Gs, Ss, Ww, Ww, Ww, Wo, Wo, Ww, Ww, Ww, Ss, Ww, Gg, Gs^Fp, Gs^Fp, Gs^Fp, Gs^Fp, Gs^Fp, Gg
Gs, Hh, Hh, Gs, Gd, Gd, Dd, Dd, Gd, Gs, Gs, Gs, Gs, Gs, Gs, Ss, Ww^Ewl, Ww, Ww, Ww, Ww, Wo, Wo, Ww, Ww, Ww, Ww, Ss, Gs^Fp, Gs^Fp, Gs^Fp, Aa^Fp, Aa^Fp, Gll^Fp
Gs, Gs, Hh^Es, Gs^Es, Gd, Dd, Dd^Es, Dd^Es, Gd, Gs, Gs, Gs^Vht, Gs, Gs^Efm, Gs, Ss, Ss, Ww, Ww, Ww, Ww, Wo, Wo, Wo, Wo, Ww, Ww, Ww, Ww, Gs^Fp, Gg, Gs^Fp, Gs^Fp, Gll^Fp
Gs, Gs, Gg, Gs, Gg, Gd, Gd, Gd^Es, Gs, Gs^Es, Gg, Gs, Gs, Gs, Gs, Gs, Ss, Ww, Ww, Ww, Ww, Ww, Wo, Wo, Wo, Ww, Wo, Ww, Ww, Gg, Ss, Gg, Gg, Gg
