border_size=1
usage=map

Gs, Gg, Gg^Efm, Gg, Gg^Efm, Gg^Efm, Gg^Efm, Gg, Gg^Efm, Gg, Gg^Efmy, Gg, Gg^Efm, Gg, Gs, Gs^Fp, Gs^Fp, Hh^Fp, Hh^Fp, Hh^Fp, Hh^Fp, Hh^Fp, Hh^Fp, Hh^Fp, Gs^Fp, Gs^Fp, Hh^Fp, Ha^Fp, Ha^Fp, Ha^Fp, Gs^Fp, Gs^Fp, Gs^Fp, Gg, Aa, Gs
Gs, Gs, Gg, Gg^Fet, Gg^Efm, Gg^Efm, Gg^Efm, Gg^Efm, Gg^Efm, Gg^Efmy, Gg^Efm, Gg^Efm, Gg^Efm, Gg^Efm, Gg, Gs, Gg^Efm, Gg, Gs^Fp, Gg^Fet, Hh^Fp, Hh^Fp, Gs^Fp, Gs^Fp, Aa^Fp, Gs^Fp, Gs^Fp, Hh^Fp, Ha^Fp, Gs^Fp, Gs^Fp, Gs^Fp, Aa^Fp, Aa^Fp, Aa, Gs
Gs, Gs, Gs, Gg, Gg, Gg^Efm, Gg, Gg^Efm, Gg^Efm, Gg^Efm, Gg^Efm, Gg^Efm, Gg, Gg, Gg, Gs^Fp, Gs^Fp, Gg^Ve, Gg^Efm, Hh^Fp, Gs^Fp, Gs^Fp, Gs^Fp, Aa^Fp, Ha^Fp, Aa^Fp, Gs^Fp, Hh^Fp, Hh^Fp, Hh^Fp, Gs^Fp, Gs, Aa^Fp, Aa^Fp, Gg^Ve, Gs
Ss, Gs, Gs, Gs, Gg, Gg, Gg, Gg, Gg, Gg, Gg, Gg, Gs, Gg, Gs, Gs, Gs, Gs^Fp, Gg^Efm, Hh^Fp, Hh^Fp, Gs^Fp, Gs^Fp, Ha^Fp, Ha^Fp, Ha^Fp, Gs^Fp, Gs^Fp, Hh^Fp, Gs^Fp, Aa^Fp, Gs, Gs, Gg^Fp, Gs, Gs
Ww, Ss, Gs, Gs, Gs, Gs, Gs, Gg, Gs, Gs, Gs, Gs, Gs, Gs, Gs, Gs, Gs, Gs, Gs, Gs^Fp, Gs^Fp, Gs^Fp, Gs^Fp, Hh^Fp, Hh^Fp, Ha^Fp, Gs^Fp, Gs^Fp, Hh^Fp, Hh^Fp, Ha^Fp, Gs^Fp, Gs^Fp, Gs, Gs, Aa
Ww, Ss, Ss, Gs, Gs, Gs, Gs, Gs, Gs, Gs, Hh, Hh, Gs, Gs, Gd, Gd, Gd, Gs, Gs, Gs^Fp, Gs, Hh^Fp, Hh^Fp, Gs^Fp, Gs^Fp, Gs^Fp, Gs, Hh^Fp, Gs, Ha^Fp, Ha^Fp, Gs^Fp, Gs, Gs, Aa, Aa
Ww, Ww, Ww, Ss, Ss, Gs, Dd^Ftd, Dd^Ftd, Dd^Vhs, Dd^Ftd, Hh^Es, Hh, Gd, Gd, Gd, Gd, Gd, Gd, Gd, Gs, Gs^Fp, Gs^Fp, Gs^Fp, Gs^Fp, Gs^Fp, Gs^Fp, Gs^Fp, Gg^Ve, Hh^Fp, Hh^Fp, Ha^Fp, Gs^Fp, Gs^Ve, Gs, Aa^Fp, Aa
Wo, Ww, Ww, Ww, Ww, Ww, Ww, Dd, Dd^Es, Dd^Es, Dd^Es, Dd^Es, Dd^Es, Dd^Es, Dd, Gd, Gd, Gd, Gd, Gs, Gs, Hh^Fp, Ss, Hh^Fp, Gs^Fp, Ha^Fpa, Gs^Fp, Gs^Fp, Ha^Fp, Ha^Fp, Hh^Fp, Gs^Fp, Gs^Fp, Aa^Fp, Aa^Fp, Aa^Fp
Wo, Wo, Wo, Wo, Ww, Ww, Ww, Ww, Ww, Dd, Dd, Dd^Es, Dd, Dd^Es, Gd, Gd, Gs, Gd, Gs, Gd, Gs, Ss, Ss, Gs, Gg^Ve, Gg, Gs^Fp, Gs^Fp, Ha^Fp, Ha^Fp, Gs, Gs^Fp, Gs^Fp, Aa^Fp, Gs, Gg
Ww, Ww, Wo, Wo, Wo, Ww, Wo, Ww, Ww, Ww, Ww, Dd, Dd^Ftd, Dd, Gd, Gs, Ss, Gs, Ss, Gs, Ss, Ss, Gs, Gs, Gs^Fp, Hh^Fp, Gs^Fp, Gs^Fp, Hh^Fp, Hh^Fp, Gs^Fp, Gs, Gs^Fp, Gs, Gs, Gs
Wo, Ww, Wo, Wo, Wo, Wo, Wo, Ww, Ww, Ww, Ww, Dd, Ww, Dd, Dd, Gs, Gs, Ss, Ss, Ss, Gs^Ft, Gs, Gs, Gs, Gs^Fp, Hh^Fp, Gs^Fp, Gs^Fp, Gs^Fp, Gs^Fp, Gs^Fp, Gg, Gs, Gs, Gg^Fp, Gg^Fp
Wo, Wo, Ww, Wo, Wo, Wo, Wo, Ww, Wo, Ww, Ww, Ww, Ww, Dd^Ftd, Dd, Gd, Gs, Ss, Gs, Ss, Gs^Ft, Gs, Gs, Gs, Gs, Ss, Gs^Fp, Gs^Fp, Gs^Fp, Gs, Gs, Gs^Fp, Gs, Gs, Gg^Fp, Gg^Fp
Ww, Ww, Ww, Ww, Ww, Wo, Wo, Wo, Wo, Ww, Ww, Ww, Ww, Ww, Ww, Gd, Gs, Ss, Ss, Gs, Gs, Gs, Ss, Gs, Gs, Gs, Gs, Gg, Gs^Fp, Gs^Fp, Gs, Gs^Fp, Gs, Gg^Ve, Gs, Gg^Fp
Ss, Ww, Ss, Ww, Ww, Wo, Ww, Wo, Wo, Wo, Wo, Ww, Ww, Ww, Ww, Ww, Ww, Ss, Gs, Gs, Gs, Ss, Gs^Ft, Ss, Gs, Gs, Gs, Gs^Fp, Gg^Efm, Gs^Fp, Gs, Gs, Gs^Fp, Gg^Fp, Aa^Fp, Gs
Gs, Ss, Gs, Ww, Ww, Ww, Ww, Ww, Ww, Wo, Wo, Wo, Ww, Ww, Ww, Ww, Ww, Ss, Ss, Ss, Ss, Ss, Gs, Gs, Gs^Es, Gs, Gs, Gg, Gg, Gg, Gs, Gs^Fp, Gs^Fp, Aa^Fp, Aa, Gg
Gs^Es, Gs^Es, Gs, Gs, Gs, Ss, Ss, Ww, Ww, Ww, Wo, Wo, Wo, Wo, Wo, Ww, Ww, Ww, Ww, Ss, Gs^Ft, Gs, Gs^Vhs, Gs, Gs, Gs^Fp, Gs^Fp, Gs, Gs, Gs^Fp, Gs, Gs, Aa^Fp, Aa^Fp, Gs, Gs
Gs, Gs^Es, Gs^Es, Gs, Gd, Gs, Gs, Ss, Ww, Ww, Ww, Wo, Wo, Wo, Wo, Ww, Ww, Ww, Ww, Ss, Gs, Gs, Gs, Gs, Gs, Gs, Gs, Gs, Gs^Fp, Gs, Cv^Fp, Gs, Gs, Gs, Gs, Gs
Gs, Gs, Gs, Gs, Gd, Gd^Es, Dd^Es, Gs, Ww, Ww, Ww, Wo, Ww, Wo, Wo, Wo, Ww, Ww, Ww, Ww, Gs, Gs, Gs, Gs, Dd^Es, Gs^Es, Gs^Es, Gs, Gs, Gs^Fp, Ke, Gs^Fp, Gs^Fp, Gg^Fp, Gg, Gs
Hh^Fp, Gs^Es, Gs, Gd^Es, Gd, Dd^Es, Dd, Dd, Dd, Ww, Ww, Ww, Ww, Wo, Wo, Wo, Ww, Ww, Ww, Ww, Ss, Gs, Gs, Gs^Es, Dd, Dd^Es, Dd^Es, Gs, Gs, Cv^Fp, Gs, Gs^Ve, Gs, Gg, Aa^Fp, Aa^Fp
Hh^Fp, Gs^Es, Hh, Gs^Es, Gs, Hh^Es, Hh, Dd, Gs, Gs, Ss, Ww, Ww, Ww, Wo, Wo, Wo, Ww, Ww, Ww, Ww, Gs, Gs, Dd, Dd^Vhs, Dd^Es, Dd, Gs, Gs, Gs, Gg^Fp, Cv^Fp, Aa^Fp, Gg, Aa, Aa^Fp
Hh^Fp, Hh, Hh^Es, Gs^Es, Sm, Gs, Gs, Gs, Gs^Efm, Gs, Gs, Ww, Ww, Ww, Ww, Wo, Wo, Ww, Ww, Ww, Ww, Ss, Gs, Dd, Dd, Dd, Gs, Gs, Gg^Fp, Gs, Gs, Gg^Fp, Gs, Gs, Gs, Aa
Hh^Fp, Mm, Hh, Sm, Sm, Hh^Fp, Hh^Fp, Gs^Vhs, Gs^Efm, Gs^Efm, Gs, Gs, Ww, Ww, Ww, Wo, Wo, Ww, Ww, Ww, Ww, Ww, Ss, Gs, Dd^Es, Dd, Gg, Gs^Fp, Gg, Gs, Gs, Gs, Gs^Fp, Gs, Gs, Gs
Hh^Fp, Hh, Hh^Fp, Hh^Es, Hh, Hh^Fp, Hh^Fp, Hh^Fp, Gs^Efm, Gs^Efm, Gs, Gs, Ww, Ww, Ww, Wo, Wo, Wo, Ww, Ww, Ww, Ww, Ww, Gs, Gs, Gs^Es, Gs, Gs, Gs, Gg^Fp, Gs, Gs, Gs^Fp, Gg^Fp, Gs, Aa^Fp
Hh^Fp, Hh, Hh^Fp, Hh^Fp, Mm, Hh^Fp, Hh^Fp, Gs^Efm, Gs^Efmy, Gs^Efm, Gs, Gs, Ww, Ww, Ww, Ww, Wo, Wo, Wo, Ww, Ww, Ww, Ww^Bhzz, Gs, Gs, Gs, Dd, Dd, Dd, Gs, Gs, Gs^Fp, Gs, Gg, Gs, Aa^Fp
Hh^Fp, Mm, Mm, Mm, Mm, Hh^Fp, Hh^Fp, Gs^Efm, Gs^Efmy, Gs^Efm, Gs, Gs, Ss, Ww, Ww, Ww, Ww, Wo, Wo, Wo, Ww^Bhzz, Ww^Bhzz, Ww, Ww, Gs, Gs, Dd, Dd^Ftd, Dd, Gs, Gs, Gs, Gs, Gs, Gs, Aa
Hh^Fp, Mm, Mm, Mm, Hh^Fp, Hh^Fp, Gs, Gs, Gs^Efm, Gs^Efm, Gs, Gs, Gs, Ss, Wwf, Ww, Ww, Ww, Wo^Bhzz, Wo^Bhzz, Wo, Ww, Ww, Ww, Ss, Gs, Dd^Es, Dd^Es, Dd^Es, Dd, Gs, Gs^Fp, Gs^Fp, Gs, Gs, Gs
Hh^Fp, Hh^Fp, Hh^Fp, Hh^Fp, Gs, Gs, Gs^Es, Gs, Gs, Gs, Gs, Gs, Gg, Gs, Gs, Ww, Ww^Bhzz, Ww^Bhzz, Ww, Wo, Wo, Wo, Ww, Ww, Ww, Gs, Gs, Dd, Gs, Gs, Gs, Gs^Fp, Gs, Gs, Aa, Aa
Gs, Hh^Fp, Hh^Fp, Hh^Fp, Hh, Gs, Gs, Gs, Gs, Ss, Gg, 1 Gg, Gg, Gs, Gs, Wwf^Bhzz, Ww, Ww, Wo, Wo, Wo, Ww, Ww, Ww, Ww, Ss, Ss, Gg, Gs^Fp, Gs^Fp, Gs, Gs, Gs, Gs, Aa^Fp, Aa^Fp
Gs, Hh^Fp, Hh, Hh, Gs, Gs, Gd, Gd, Gd, Gs, Gs, Gg, Gs, Gs, Gs, Wwf, Ww, Ww, Ww, Wo, Wo, Wo, Ww, Ww, Ww, Ww, Ww, Gs, Gs^Fp, Gs^Fp, Gs^Fp, Gs^Vht, Gs^Fp, Gs, Gs, Aa
Gs, Hh, Hh, Gs, Gd, Gd, Dd, Dd, Gd, Gs, Gs, Gs, Gs, Gs, Gs, Ss, Ww^Ewl, Ww, Ww, Ww, Wo, Wo, Wo, Ww, Ww, Ww, Ww, Ss, Gs^Fp, Gs^Fp, Gs^Fp, Aa^Fp, Aa^Fp, Gs, Aa^Fp, Aa
Gs, Gs, Hh^Es, Gs^Es, Gd, Dd, Dd^Es, Dd^Es, Gd, Gs, Gs, Gs^Vht, Gs, Gs^Efm, Gs, Ss, Ss, Ww, Ww, Ww, Ww, Wo, Wo, Wo, Wo, Ww, Ww, Ww, Ww, Gs^Fp, Gs, Gs^Fp, Gs^Fp, Gs, Gs, Aa^Fp
Gs, Gs, Gg, Gs, Gg, Gd, Gd, Gd^Es, Gs, Gs^Es, Gg, Gs, Gs, Gs, Gs, Gs, Ss, Ww, Ww, Ww, Ww, Wo, Wo, Wo, Wo, Ww, Wo, Ww, Ww, Ss, Ss, Gs, Gs, Gs, Gs, Aa
