border_size=1
usage=map

Mm, Mm, Mm, Hh^Fmf, Hh^Fmf, Hh^Fmf, Gs^Fmf, Ss, Ss, Ww, Ww, Gs, Ds, Ds^Ft, Ds^Ft, Ds^Ft, Ds, Ds, Rd, Ds, Ds, Ds, Ds, Ds, Ss, Ss, Ss
Mm, Mm, Mm, Hh^Fmf, Hh^Fmf, Hh^Fmf, Gs^Fmf, Ss, Rd, Gs, Ww, Ds, Ds, Ds, Ds, Ds^Ft, Ds, Rd, Ds, Ds, Ds^Vht, Ds, Ds, Ds, Ds, Ss, Ss
Mm, Mm, Hh, Hh^Fmf, Hh, Gs^Fmf, Gs^Fmf, Rd, Ss, Gs, Ww, Ds, Ds, Ds^Vdt, Ds, Ds^Ft, Rd, Rd, Ds, Ds, Ds, Ds, Ss, Ss, Ss, Ss, Ss
Mm, Mm, Hh^Ftp, Hhd^Fmf, Hh^Ftp, Gg, Gs^Fmf, Gs^Fmf, Gs, Ss, Ss, Ww, Ds, Ds, Ds, Ds, Rd, Ds, Ds, Ds^Dr, Ds, Ss, Ww, Ww, Ww, Ww, Ss
Hh^Ft, Hh^Ftp, Hh^Ftp, 2 Hh^Ftp, Hh^Ftp, Gs^Fmf, Gs^Fmf, Gs, Gs^Fmf, Ss, Ww, Ww, Gd, Ds, Ds, Rd, Ds, Ds, Ds, Ds, Ds, Ss, Ww, Wo, Ww, Ss, Ss
Dd^Ftd, Hh^Fmf, Hh^Fmf, Hh^Ftp, Hh^Fmf, Hh, Gs, Gs, Wwf, Ss, Ww, Gd, Dd^Ftd, Ds, Rd, Rd, Ds, Ds^Ft, Ds^Ft, Ds, Ds, Ss, Ds, Ww, Ds, Ds, Ds
Dd^Ftd, Dd^Ftd, Wwf, Gg, Gd^Fmf, Gg, Gd, Ss, Ww, Wwf, Gd, Gd, Ds, Ds, Rd, Ds, Ds, Ds^Ft, Ds, Ds, Rd, Ds, Rd, Ds, Rd, Ds, Ds
Ss, Dd^Ftd, Wwf, Gd, Hhd^Fmf, Gd^Fmf, Gd^Fmf, Ss, Ww, Gs^Ft, Gd, Dd^Ftd, Ds, Rd, Ds, Ds, Ds, Ds, Ds, Rd, Ds, Rd, Ds, Rd, Ds, Rd, Ds
Ss, Dd^Ftd, Ww, Hh, Hhd^Fmf, Hhd^Fmf, Gd^Fmf, Ww, Gs^Ft, Gs^Ft, Gd, Ds, Ds, Rd, Rd, Ds, Dd^Dc, Ds, Rd, Rd, Ds, Ds, Ds, Ds, Gd, Rd, Gd
Ss, Ss, Gd, Wwf, Gll^Fmf, Gd^Fmf, Gll^Fmw, Ww, Gs^Ft, Gd, Dd^Ftd, Ds, Ds, Ds^Dr, Rd, Ds, Ds, Ds, Rd, Ds, Ds, Ds, Gd^Vht, Gd, Gll^Fmw, Gll^Fmw, Gd
Ss, Gd, Hh^Fmf, Wwf, Ss, Gd, Ss, Ss, Gs^Ftp, Gd, Gd, Ds, Ds, Ds, Ds, Rd, Dd, Dd, Dd, Rd, Ds, Ds, Ds, Gd, Gd, Gd, Ds
Ss, Gd, Gd^Vht, Ww, Ww, Ww, Gs^Ft, Gs^Ft, Gd, Gd, Dd^Ftd, Ds, Ds, Hd, Ds, Rd, Rd, Rd, Rd, Rd, Ds, Ds, Ds, Ds, Ds, Ds, Hd
Ww, Ss, Hh^Fmf, Gs^Fmf, Ww, Gs^Ft, Gd, Gs^Ft, Gs^Ft, Gd, Rd, Ds, Ds, Hd, Ds, Dd, Rd, Dd, Ds, Ds, Hd, Hd, Hd, Ds, Ds, Ds, Hd
Ww, Dd^Ftd, Gs, Gs, Gs, Wwf, Gd, Gs^Ft, Gd, Gd, Rd, Ds, Ds, Ds^Edp, Ds, Rd, Ds, Ds, Ds, Hd, Hd, Hd, Hd, Ds, Ds, Hd, Hd
Ww, Dd^Ftd, Ss, Hh^Fmf, Gs, Wwf, Ww, Gd, Gd, Dd^Ftd, Ds, Rd, Rd, Ds, Rd, Rd, Ds, Ds, Ds^Dr, Ds, Ds, Ds, Ds, Ds, Ds, Hd, Hd
Ww, Dd^Ftd, Ss, Hh, Gs^Fmw, Gs^Fmf, Ww, Gd, Gd, Ds, Ds, Ds, Rd, Ds, Rd, Ds, Hd, Ds, Ds^Ft, Ds^Ft, Ds, Ds, Ds, Ds, Ds, Hd, Hd
Ss, Ss, Hh, Hh^Fmf, Gs, Gs, Wwf, Gd, Gd, Gd, Rd, Ds, Rd, Rd, Ds, Ds, Hd, Ds, Ds, Ds^Ft, Ds, Ds, Ds, Gd, Gll^Fmw, Ds, Ds
Ss, Ss, Hh^Fmf, Gs^Fmw, Rd, Gs^Fmf, Ss^Vhs, Wwf, Ds, Gd, Ds, Rd, Ds^Dr, Rd, Rd, Ds, Ds, Ds, Dd^Vdt, Ds, Ds, Ds, Ds, Gd, Gll^Fmw, Ds, Ds
Ss, Dd^Ftd, Hh^Fmf, Gs^Fmf, Gs^Fmf, Gs^Fmw, Ss, Ww, Ds, Ds, Dd^Dc, Ds, Ds, Ds^Ft, Rd, Ds, Ds, Ds, Ds, Ds, Hd, Ds, Ds, Ds, Ds, Ds, Ds
Ss, Dd^Ftd, Dd^Ftd, Hh, Gs^Fmf, Gs^Fmf, Ss, Ww, Ds, Ds, Ds, Ds, Ds, Ds^Ft, Ds^Ft, Rd, Ds, Ds^Edp, Ds, Ds, Hd, Hd, Ds, Ds, Ds, Ds, Dd^Ftd
Ss, Ss, Dd^Ftd, Hh^Fmf, Gs^Fmw, Ss, Ss, Ss, Dd^Ftd, Ds, Ds, Ds, Ds, Ds, Ds, Rd, Rd, Ds, Ds, Hd, Hd, Hd, Ds, Ds, Ds^Vht, Ds, Dd^Ftd
Ss, Dd^Ftd, Hh^Fmf, Hh, Hh^Fmf, Gs^Fmf, Gs^Fmw, Ss, Dd^Ftd, Ds, Ds, Ds, Ce, Rd, Rd, Rd, Dd, Rd, Ds, Ds, Ds, Ds, Ds, Ds, Ds, Ds, Dd^Ftd
Ss, Dd^Ftd, Dd^Ftd, Hh^Fmf, Hh, Gs^Fmf, Gs^Fmf, Ss, Dd^Ftd, Ds, Ds, Ce, 1 Ke, Ce, Rd, Ds, Ds, Rd, Rd, Ds, Rd, Ds^Fts, Dd^Ftd, Ds, Ds, Ds, Dd^Ftd
Ss, Ss, Dd^Ftd, Hh^Fmf, Hh^Fmf, Hh^Fmf, Hh, Ss, Ss, Ds, Ds, Ce, Ce, Ce, Ds, Ds, Ds, Dd, Ds, Rd, Ds, Rd, Rd, Ds, Ds, Dd^Ftd, Dd^Ftd
Ss, Ss, Dd^Ftd, Dd^Ftd, Dd^Ftd, Hh^Fmf, Gs^Fmw, Ss, Ss, Dd^Ftd, Ds, Ds, Ds, Dd^Vdt, Ds, Ds, Ds^Ft, Ds, Ds, Ds, Dd^Ftd, Ds, Ds, Rd, Rd, Ds, Ss
Ss, Ss, Dd^Ftd, Dd^Ftd, Hh^Fmf, Hh^Fmf, Gs^Fmf, Gs^Fmf, Gs^Fmf, Ss, Ss, Ds, Ds, Ds, Ds, Ds^Ft, Ds^Ft, Ds, Ds, Ds, Dd^Ftd, Dd^Ftd, Ds, Ds, Ds, Ss^Bw\, Ss^Bw\