border_size=1
usage=map

Hh^Fp, Gs^Fms, Hh^Fp, Hh^Fp, Hh^Fp, Hh^Fp, Hh^Fp, Hh^Fp, Hh^Fp, Hh^Fp, Hh^Fp, Hh^Fp, Gs^Fp, Gs^Fp, Gg, Gg, Gs, Gs, Gg, Gg, Gs^Fp, Gg, Gg, Gs^Fp, Gg, Gg, Gs^Fp, Gg, Gg, Gg, Gg, Gg, Gg, Gg, Gg, Hh^Fp, Hh^Fp, Hh
Gs^Fms, Hh^Fp, Hh^Fp, Hh^Fp, Hh^Ve, Hh^Fp, Hh^Fp, Hh^Fp, Hh^Fp, Hh^Fp, Gs^Fp, Gs^Fp, Gg, Gg, Gs, Gs, Gs, Gs, Gs, Gg, Gs^Fp, Gs^Fp, Gg, Gs^Fp, Gs^Fp, Gs^Fp, Hh^Fp, Gs^Fp, Gg, Gg, Gg, Gg, Gs^Fp, Gs^Fp, Gs^Fp, Hh^Fp, Hh^Fp, Hh
Gs^Fp, Gs^Fms, Gs^Fp, Gs^Fp, Gs^Fp, Gs^Fp, Gs^Fp, Hh^Fp, Gs^Fp, Gs^Fp, Ss, Gg, Gg, Gs, Gs, Gs^Vht, Gs, Gs, Gs, Gg, Gg, Gg, Gg, Gg, Gs^Fp, Hh^Fp, Hh^Fp, Gg, Gs^Fp, Gg, Gs^Fp, Gg, Gg, Hh^Fp, Hh^Vhhr, Gs^Fp, Gg, Gg
Ss, Gs^Fp, Ss, Gs^Fp, Ss^Bw|, Gs^Fp, Ss, Gs^Fp, Ss, Ss, Ss, Ss, Gg, Gs, Gg, Gs, Gg, Gg, Gg, Gs, Gg, Gg, Gg, Gg, Gg, Gs^Fp, Gs^Fp, Gs^Fp, Gg, Gg, Gg^Fp, Gs^Fp, Hh^Fp, Gg, Hh^Fp, Gs^Fp, Gg, Gs
Ss, Ss, Ss, Ss, Ss^Bw|, Ss, Ss, Ss, Ss, Ss, Ss, Ss, Ss, Gg, Ss, Gg, Gs^Fp, Gs^Fp, Gs^Fp, Gg, Gs^Fp, Gs^Fp, Gs^Fp, Gg, Gs, Gg, Gg, Gg, Gs^Fp, Gg, Gg, Gs^Fp, Gs^Fp, Hh^Fp, Gs^Fp, Gs^Fp, Gg, Gs
Ss, Ss^Vhs, Ss, Ss, Gs, Ss, Ss, Ss^Vhs, Ss, Ss, Ss, Ss, Ss, Ss, Ss, Ss, Gs^Fp, Gs^Fp, Hh^Fp, Gs^Fmw, Hh^Fp, Hh^Fp, Gs^Fp, Gg, Gg, Gs, Gg, Gs^Fp, Gg, Gg, Gg^Fp, Gg, Gs^Fp, Gs^Fp, Gg, Gg, Gs, Ds
Ss, Ss, Gs, Gs, Rp, Gs, Ss, Ss, Ss, Ss, Ss, Ss, Ss, Ss, Gs^Fp, Ss, Gs^Fp, Gs^Fp, Gs^Fp, Hh^Fp, Gs^Fms, Hh^Fp, Hh^Ve, Gs^Fp, Gs^Fp, Gg, Gg, Gg, Gg, Gs^Fp, Gg, Gg, Gg, Gg, Ds, Gs, Ds, Ds
Ss, Ss, Rp, Rp, Chr, Rp, Rp, Gs, Ss, Ss, Ss^Vhs, Ss, Ss, Gs^Fp, Gs^Fp, Gs^Fp, Gs^Fp, Gs^Fp, Gs^Fp, Gs^Fp, Gs^Fp, Gs^Fms, Gs^Fmf, Hh^Fp, Hh^Fp, Gs^Fp, Gs^Fp, Gg, Gg, Gg, Gs, Gg, Gs, Ds, Ds, Gg, Ds, Hd
Ss, Gs, Rp, Ch, 2 Kh, Ch, Rp, Gs, Ss, Ss, Ss, Ss, Ss, Gs^Fp, Gs^Fp, Gs^Fp, Gs^Fp, Gs^Fp, Gg^Efm, Gg^Efm, Gg^Efm, Gs^Fp, Gg, Gs^Fms, Gs^Fms, Gs^Fms, Hh^Fp, Gs^Fp, Gg, Gs, Gg, Gs^Vht, Gs, Ds, Gs, Gs, Ds, Hd
Ss, Ss, Rp, Ch, Ch, Ch, Rp, Gs, Gs, Ss, Gs, Ss, Ss, Gs^Fp, Gs^Fp, Gs^Fp, Gs^Fp, Gs^Fp, Gg^Efm, Gg^Fet, Gg^Efm, Gg^Efm, Gg, Gg^Fp, Gg^Fp, Hh^Fp, Hh^Fms, Gs^Fp, Ss, Gs, Gs, Gg, Gs, Gs, Gg, Gg, Gg, Ds
Ss, Ss, Ss^Vhs, Rp, Rp, Rp, Gs, Gs, Ss, Gs, Gs, Gs, Ss, Gs^Fp, Gs^Fp, Gs^Fp, Gg, Gg, Gg, Gg^Efm, Gg, Gg, Gg, Gg^Fp, Hh^Fp, Hh^Fms, Hh^Fms, Gs^Fp, Ss, Ds, Ds, Gs, Gs, Gs, Gg, Gs^Fp, Gg, Ds
Ww, Ss, Ss, Ss, Ss, Ss, Ss, Gs, Ss, Ss, Gs, Gs, Gs, Gs^Fp, Gs^Fp, Gs^Fp, Gg, Gg^Ve, Gs^Fp, Gg, Gg, Gg, Gg^Fp, Gg^Fp, Gs^Fms, Hh^Fms, Gs^Fp, Gs^Fp, Ss, Ds, Hd, Ds, Gs, Gg, Gs^Fp, Gs^Fp, Gs^Fp, Gg
Ww, Ww, Ww, Ss, Ww, Ss, Ww, Ss^Bw|, Ww, Ss^Vhs, Ss, Ss, Gs, Gg^Fp, Gg^Efm, Gg^Efm, Gg^Efm, Gs^Fp, Gs^Fp, Gg, Gg, Gg, Gg, Gs^Fms, Gs^Fp, Gs^Fp, Hh^Fp, Ss, Hd, Ds, Ds, Ds, Gs, Gg, Gs^Fp, Gs^Fp, Gs^Fp, Gg
Wo, Ww, Ww, Ww, Ww, Ww, Wo, Ww^Bw|, Wo, Ww, Wwf, Ss, Gs, Gg, Gg^Efm, Gg^Fet, Gg^Efm, Gs^Fp, Gs^Fp, Gs^Fp, Gg, Gg^Ve, Gg, Gs^Fp, Hh^Fp, Hh^Fp, Hh^Fp, Ds, Hd, Ds, Ds, Gs, Gs, Gg, Gg, Gg, Gg, Gg
Ww, Wo, Wo, Wo, Wo, Wo, Wwf, Wo^Bw|, Wwf, Wo, Wo^Bw/, Wwf, Gs^Fp, Gs^Fp, Gs^Fp, Gg^Efm, Gs^Fp, Gg, Gs^Fp, Gg^Fp, Gg^Fp, Gg, Gs^Fp, Gg^Fp, Hh^Fp, Hh^Fp, Ds, Ds, Ds, Hd, Ds, Ds, Gs, Gs, Gs, Gg, Gs, Gs
Ww, Ww, Wo, Wo, Ww, Ww, Ds, Ds, Ds, Wwf, Wo, Ww, Ww, Gs^Fp, Gs^Fp, Gs^Fp, Gg^Fp, Gs^Fp, Gs^Fp, Gs^Fp, Gs^Fp, Gs^Fp, Gg^Fp, Gs^Fp, Hh^Fp, Hh^Fp, Ds, Ds, Hd, Hd, Hd, Ds, Gs, Gs^Vht, Gs, Gs, Gs, Gs
Gs, Ww, Ww, Wo, Wo, Ww, Ww, Ds, Ww, Ww, Wo, Ww, Ww, Ww, Ww, Ds, Ds, Gs^Fp, Gs^Fp, Gs^Fp, Gs^Fp, Gs^Fp, Gs^Fp, Gs^Fp, Hh^Fp, Hh^Fp, Ds, Hd, Ww, Ds, Hd, Ds, Ds, Gs, 1 Gg, Gs, Gs, Gs
Gs, Gs, Ww, Ww, Ww, Wo, Wo, Ww^Bw|, Wo, Wo, Wo, Wo, Wo, Ww, Ww, Ww, Ww, Ds, Ww, Gs^Fp, Gs^Fp, Gs^Fp, Gs^Fp, Gs^Fp, Gs^Fp, Hh^Fp, Ds, Hd, Ww, Ds, Hd, Ds, Ds, Gs, Gg, Gs, Gs, Gs
Gs, Gs, Gs, Wwf, Wwf, Ww, Wwf, Wo^Bw|, Ww, Ww, Ww, Wo, Wo, Wo, Wo, Ww, Ww, Ww, Ww, Ww, Ww, Gs^Fp, Ww, Gs^Fp, Gs^Fp, Gs^Fp, Ds, Ds, Ww, Ds, Ds, Ds, Ds, Gs, Gs, Gs, Gg, Gs
Hh^Fp, Hh^Fp, Hh^Fp, Gs, Gs, Gs, Gs, Wwf, Wwf, Ww, Ww, Ww, Ww, Wo, Wo, Wo, Wo, Ww, Ww, Ww, Ww, Ww, Ww, Ww, Ww, Ds, Ww, Ww, Ww, Ds, Ds, Ds, Ds, Ds, Ds, Ds, Ds, Gg
Mm, Mm, Mm, Hh^Fp, Hh^Fp, Hh^Fp, Hh^Fp, Gs, Gs, Wwf, Wwf, Ww, Ww, Ww, Ww, Ww, Ww, Wo, Wo, Wo, Wo, Ww, Ww, Ww, Ww, Ww, Ww, Ww, Ww, Ww, Ww, Ds, Ww, Ds, Ww, Ds, Ww, Ds
Mm, Mm, Mm^Vhhr, Mm, Hh^Fp, Mm, Mm, Hh^Fp, Hh^Fp, Gs, Gs, Wwf, Gs, Ww, Ww, Ww, Ww, Ww, Ww, Wo, Ww, Wo, Wo, Wo, Wo, Ww, Ww, Wo, Ww, Ww, Ww, Ww, Ww, Ww, Ww, Ww, Ww, Ww
Mm, Mm, Mm, Mm, Ce, Mm, Mm, Mm, Hh^Fp, Gs^Fp, Hh^Fp, Gs, Gs, Gs, Gs, Gs, Gs, Ww, Ww, Ww, Ww, Ww, Ww, Wo, Ww, Wo, Wo, Wo, Wo, Wo, Wo, Ww, Wo, Ww, Wo, Ww, Wo, Ww
Mm, Mm, Mm, Mm, 3 Ke, Ce, Mm, Mm, Mm^Vhhr, Hh^Fp, Mm, Hh^Fp, Hh^Fp, Gs^Fp, Gs^Fp, Gs, Gs^Fp, Gs, Gs, Ww, Gs, Ww, Ww, Ww, Ww, Ww, Ww, Ww, Ww, Ww, Ww, Wo, Ww, Wo, Ww, Wo, Ww, Wo
Mm, Mm, Mm, Mm, Mm, Mm, Mm, Mm, Mm, Mm, Mm, Mm, Mm, Hh^Fp, Hh^Fp, Hh^Fp, Hh^Fp, Gs^Fp, Hh^Fp, Gs, Gs^Fp, Gs, Gs, Gs, Gs, Ww, Gs, Ww, Ww, Ww, Ww, Ww, Ww, Ww, Ww, Ww, Ww, Ww
Mm, Mm, Mm, Mm, Mm, Mm, Mm, Mm, Mm, Mm, Mm, Mm, Mm, Mm, Mm, Mm, Mm, Hh^Fp, Mm, Hh^Fp, Hh^Fp, Gs^Fp, Gll^Fp, Gs^Fp, Gs^Fp, Gs^Fp, Gs^Fp, Gs, Gs, Gs, Gs, Gs, Gs, Ww, Gs, Ww, Gs, Ww