border_size=1
usage=map

Xu, Xu, Qxu, Xu, Xu, Xu, Xu, Xu, Xu, Xu, Xu, Xu, Xu, Xu, Xu, Xu, Xu, Xu, Xu, Xu, Xu, Qxu, Qxu, Qxu, Qxu, Xu, Rr^Es, Rr^Es, Rr, Rr, Qxu, Qxu, Qxu, Qxu, Qxu, Qxu, Qxu, Qxu, Qxu
Xu, Qxu, Qxu, Qxu, Qxu, Qxu, Qxu, Qxu, Qxu, Qxu, Qxu, Qxu, Qxu, Qxu, Qxu, Qxu, Xu, Rr, Rr, Rr, Qxu, Qxu, Qxu, Qxu, Rr, Rr, Rr, Rr^Es, Rr, Qxu, Qxu, Ql, Qxu, Ql, Ql, Ql, Ql, Ql, Ql
Xu, Qxu, Uu^Vud, Qxu, Cud, Qxu, Cud, Qxu, Cud, Cud, Cud, Cud, Cud, Ur, Cud, Ur, Xu, Cud, Rr, Rr, Rr, Qxu, Qxu, Qxu, Qxu, Qxu, Qxu, Rr, Rr, Rr, Rr, Qxu, Rr, Qxu, Ql^Bh/, Uu, Ql, Ql, Ql
Xu, Qxu, Qxu, Uu, Cud, Cud, Cud, Cud, Cud, Uu^Vud, Cud, Cud, Cud, Ur, Ur, Ur, Xu, Cud, Rr, Rr, Rr^Es, Rr, Rr, Rr, Rr, Qxu, Qxu, Qxu, Rr, Rr, Rr, Rr, Rr, Rr, Rr, Ql, Qxu, Ql, Ql
Xu, Qxu, Qxu, Cud, Cud, Cud, Cud, Cud, Qxu, Cud, Qxu, Qxu, Qxu, Qxu, Qxu, Qxu, Xu, Rr, Qxu, Rr, Rr, Rr^Es, Rr, Rr, Rr, Qxu, Rr, Rr, Rr^Es, Rr, Cud, Cud, Cud, Rr, Rr^Es, Ql, Qxu, Qxu, Qxu
Xu, Qxu, Cud, Cud, Uu^Vud, Cud, Qxu, Qxu, Ql, Qxu, Ql, Qxu, Ql, Ql, Qxu, Xu, Uu, Xu, Qxu, Rr, Qxu, Rr, Rr, Rr^Vhcr, Rr, Rr, Rr, Rr, Rr, Rr, Cud, 2 Kud, Cud, Rr^Es, Rr^Es, Rr, Rr, Xu, Xu
Xu, Qxu, Qxu, Cud, Cud, Cud, Qxu, Qxu, Ql, Ql, Ql, Ql, Ql, Ql, Qxu, Qxu, Uu, Xu, Rr, Qxu, Qxu, Rr, Rr, Rr, Rr^Es, Rr, Qxu, Qxu, Qxu, Rr, Rr, Cud, Rr, Rr, Rr, Qxu, Rr, Rr^Es, Xu
Xu, Qxu, Cud, Cud, Cud, Cud, Qxu, Ql, Ql, Ql, Ql, Ql, Ql, Qxu, Uu, Uu, Uu, Xu, Rr^Es, Rr, Qxu, Qxu, Rr, Rr^Es, Rr^Es, Rr, Rr, Qxu, Rr, Rr, Rr, Rr, Rr, Rr, Qxu, Qxu, Rr, Rr^Es, Xu
Xu, Qxu, Qxu, Cud, Cud, Cud, Qxu, Ql, Qxu, Ql, Qxu, Qxu, Qxu, Qxu, Uu, Uu^Vud, Uu, Xu, Rr^Es, Rr, Rr, Qxu, Qxu, Rr, Rr^Es, Rr^Es, Rr, Rr, Rr, Rr^Es, Rr, Rr, Qxu, Rr, Rr, Rr, Rr, Rr, Qxu
Xu, Qxu, Cud, Cud, Uu^Vud, Cud, Cud, Qxu, Qxu, Qxu, Cud, Cud, Cud, Qxu, Cud, Uu, Cud, Xu, Rr, Rr, Rr, Qxu, Qxu, Rr, Rr, Rr^Es, Rr, Rr^Vhcr, Rr, Rr, Rr, Qxu, Qxu, Qxu, Rr, Rr^Vhcr, Rr, Rr, Qxu
Xu, Qxu, Qxu, Cud, Cud, Cud, Cud, Cud, Cud, Cud, Uu^Vud, Cud, Cud, Ur, Ur, Cud, Cud, Xu, Rr, Rr^Vhcr, Rr, Rr, Qxu, Rr, Rr, Rr, Qxu, Rr, Qxu, Rr, Rr, Rr, Qxu, Qxu, Rr, Rr, Rr, Rr, Xu
Xu, Qxu, Cud, Cud, Cud, Cud, Cud, Cud, Cud, Cud, Cud, Cud, Qxu, Ur, Xu, Ur, Kud, Xu, Rr^Es, Rr^Es, Rr, Rr, Qxu, Qxu, Rr, Rr, Qxu, Qxu, Qxu, Rr, Rr, Qxu, Rr, Rr, Rr, Rr^Es, Rr^Es, Xu, Xu
Xu, Qxu, Qxu, Cud, Uu, Cud, Qxu, Cud, Qxu, Qxu, Qxu, Qxu, Xu, Xu, Ur, Xu, Xu, Xu, Xu, Rr^Es, Rr^Es, Rr^Es, Rr, Rr, Rr^Es, Rr, Rr, Rr, Rr, Rr, Rr, Rr, Rr, Rr, Xu, Rr^Es, Xu, Xu, Qxu
Xu, Qxu, Qxu, Uu, Uu^Vud, Uu, Uu, Qxu, Xu, Xu, Xu, Xu, Sm, Ur^Es, Ur, Ur^Es, Uh, Uh, Uh, Xu, Xu, Rr^Es, Rr, Rr^Es, Rr^Es, Rr, Rr, Rr, Xu, Rr^Es, Xu, Rr^Es, Xu, Xu, Sm, Xu, Sm, Qxu, Qxu
Xu, Qxu, Xu, Uu, Uu, Uu, Xu, Xu, Uu, Uu, Uu, Sm, Ur^Es, Ur, Cud, Ur, Ur^Es, Uu, Uu, Uu, Uu, Xu, Xu, Rr^Es, Xu, Rr^Es, Xu, Xu, Sm, Xu, Sm, Xu, Qxu, Qxu, Uu, Sm, Sm, Sm, Qxu
Xu, Xu, Ss, Xu, Xu, Uu, Xu, Uh, Uu, Uu^Vu, Uu^Es, Ur^Es, Ur^Es, Ur, Ur, Ur, Ur^Es, Uu, Uu, Uu^Vu, Uu, Uu, Xu, Xu, Uu, Xu, Uu, Sm, Uu^Vu, Sm, Sm, Sm, Sm, Uu, Uu^Vu, Uu, Sm, Sm, Qxu
Xu, Ss, Ss^Vm, Ss, Ur^Es, Xu, Xu, Uh, Ur^Es, Uu, Ur^Es, Ur, Ur, Ur, Cud, Ur, Ur, Ss, Ss, Uu, Ur^Es, Uh, Xu, Uh, Ur^Es, Uu, Ur^Es, Uu, Uu, Uu, Uu, Uu, Uu, Uu, Uu, Uu, Sm, Qxu, Qxu
Xu, Ss, Ss, Ss, Ur^Es, Xu, Ur^Es, Ur^Es, Cud, Ur, Ur^Es, Ur, Ur, Cud, Uu, Cud, Ur, Ur, Ur, Ur, Cud, Ur^Es, Ur^Es, Xu, Ur^Es, Ur^Es, Ur^Es, Ur^Es, Ur^Es, Ur^Es, Ur^Es, Uu^Uf, Uu, Cud, Cud, 3 Kud, Sm, Sm, Qxu
Xu, Ss, Ss, Ur, Xu, Xu, Xu, Ur^Es, Ur, Ur, Ur, Ur^Es, Ur, Cud, Cud, Cud, Ur, Ur^Es, Ur^Es, Ur, Ur^Es, Ur, Xu, Xu, Uu, Ur^Es, Ur^Es, Ur^Es, Ur, Ur^Es, Ur, Ur^Es, Ur^Es, Ur, Ur, Cud, Sm, Sm, Qxu
Xu, Ss, Ur, Ur, Ss, Ss, Xu, Uu, Ur, Ur, Ss, Ur, Ur, Ur, Ur, Ur, Ss, Ur, Ur, Ur, Ur^Es, Uu, Xu, Xu, Xu, Uu, Ur^Es, Ur^Es, Uu, Ur, Uu, Ur^Es, Ur, Ur, Uu, Ur, Ur, Sm, Qxu
Xu, Ss, Ur, Ur, Ss^Vm, Ss, Xu, Uu, Uu, Ur, Ur, Ss, Ur^Es, Ur^Es, Ur^Es, Ur, Ss, Ss, Ur, Ur^Es, Uu, Uu, Xu, Qxu, Xu, Uu, Ur^Es, Uu, Xu, Uu, Xu, Uu, Uu, Uu, Uu^Uf, Uu, Ur, Qxu, Qxu
Xu, Ss, Ur, Ss, Ur, Ss, Ur^Es, Xu, Uu, Ur, Uu^Uf, Ur, Ur, Ur, Cud, Ur, Ur, Ur, Ur, Uu, Uu^Uf, Xu, Qxu, Qxu, Qxu, Xu, Xu, Xu, Uu, Xu, Uu, Xu, Xu, Xu, Uu, Uu, Qxu^Bh|, Qxu, Qxu
Xu, Ss, Ur, Ur^Es, Ur^Es, Ss, Ur^Es, Xu, Xu, Uu, Uu, Ur^Es, Ur^Es, Ur^Es, Ur, Ur, Ur^Es, Ur^Es, Ur, Uu, Uu, Xu, Qxu, Sm, Qxu^Bs\, Sm, Uu, Ur, Uu^Vu, Uu, Ur, Uu, Uu, Xu, Qxu, Qxu, Ur, Qxu, Qxu
Xu, Xu, Xu, Ur^Es, Ur^Es, Ur^Es, Ur, Ur^Es, Xu, Uu, Uu^Vu, Uu, Uu, Ur^Es, Ur^Es, Ur, Ur, Ss, Ur, Ur^Es, Uu, Xu, Xu, Qxu, Sm, Sm, Uu, Ur^Es, Ur^Es, Ur, Cud, Ur, Uu, Xu, Uu, Ur, Uu, Uu, Qxu
Ww, Ww, Chw, 4 Khw, Xu, Ur^Es, Xu, Uh, Xu, Uu, Uu, Uu, Xu, Uu, Uu, Uu, Uu, Ur, Ur, Ur^Es, Ur^Es, Uu, Uu, Xu, Xu, Xu, Xu, Uu, Uu, Ur, Ur, Ur, Sm, Xu, Uu, Ur^Es, Qxu, Qxu, Qxu
Ww, Ww, Ww, Chw, Wwf, Xu, Dd, Xu, Dd^Es, Xu, Xu, Xu, Uu, Xu, Xu, Xu, Xu, Uu, Ur^Es, Ur^Es, Ur, Ur, Ur, Uu, Uu, Uu, Uu, Xu, Xu, Sm, Sm, Sm, Qxu, Xu, Uu, Ur, Qxu, Qxu, Qxu
Wo, Ww, Ww, Ww, Ww, Wwf, Dd, Dd, Dd^Vdt, Dd^Es, Xu, Qxu, Qxu, Wwf, Ww, Ss, Xu, Uu, Uu, Ur, Ur, Ss, Ss, Ur, Ur^Es, Ur^Es, Ur^Es, Uu, Uu, Xu, Xu, Sm, Qxu, Xu, Qxu, Qxu^Bh|, Qxu, Qxu, Xu
Wo, Wo, Ww, Ww^Vm, Ww, Wwf, Rd, Dd, Dd, Dd, Dd, Xu, Xu, Qxu, Xu, Ww, Ww, Xu, Xu, Uu, Uu, Ur, Ur, Ur, Ur^Es, Ur^Es, 1 Ur, Ur^Es, Ur, Uu, Uu, Xu, Xu, Qxu, Qxu, Ur, Uu, Xu, Xu
Wo, Wo, Wo, Ww, Ww, Wwf, Dd, Rd, Rd, Rd, Rd, Dd, Dd, Xu, Chw, Wwf, Ww, Ww, Xu, Uu, Uu, Ur, Ur, Ur^Es, Ur, Ur, Ur, Ur, Ur^Es, Ur, Uu, Uh, Uh, Xu, Uu, Ur^Es, Ur^Es, Uu, Xu
Wo, Wo, Ww, Ww, Ww, Dd, Dd^Vdt, Dd, Dd, Dd, Dd, Rd, Rd, Rd, Xu, Wwf, Ww, Ww, Ss, Xu, Uh, Uu, Uu, Ur^Es, Ur^Es, Ur, Ur, Ur, Ur, Ur, Ur^Es, Uh, Md, Xu, Xu, Uu, Cud, Uu, Xu
Wo, Wo, Ww, Ww, Dd, Dd, Dd, Dd, Dd^Es, Dd^Es, Dd^Es, Dd, Dd^Es, Dd, Dd^Es, Xu, Ss, Wwf, Ss, Xu, Xu, Uh, Xu, Uu, Uu, Uu, Uu, Uu, Uh, Uh, Rd, Hd, Hd, Md, Xu, Uu, Sm, Sm, Xu
Wo, Ww, Xu, Xu, Xu, Xu, Xu, Xu, Xu, Xu, Xu, Xu, Xu, Xu, Xu, Xu, Ss, Ss, Xu, Xu, Xu, Xu, Xu, Xu, Xu, Xu, Xu, Xu, Xu, Hd, Rd, Dd^Esd, Hd, Md, Md, Xu, Xu, Xu, Xu
