border_size=1
usage=map

Xu, Xu, Qxu, Xu, Xu, Xu, Xu, Xu, Xu, Xu, Xu, Xu, Xu, Xu, Xu, Xu, Xu, Xu, Xu, Xu, Xu, Qxu, Qxu, Qxu, Qxu, Xu, Rr^Es, Rr^Es, Rr, Rr, Qxu, Qxu, Qxu, Qxu, Qxu, Uu, Ur, Uu, Qxu
Qxu, Qxu, Qxu, Qxu, Qxu, Qxu, Qxu, Qxu, Qxu, Qxu, Qxu, Qxu, Qxu, Qxu, Qxu, Qxu, Xu, Rr, Rr, Rr, Qxu, Qxu, Qxu, Qxu, Rr, Rr, Rr, Rr^Es, Rr, Qxu, Qxu, Ql, Qxu, Ql, Ql, Uu, Ur, Qxu, Ql
Qxu, Qxu, Uu^Vud, Qxu, Cud, Qxu, Cud, Qxu, Cud, Cud, Cud, Cud, Cud, Ur, Cud, Ur, Xu, Cud, Rr, Rr, Rr, Qxu, Qxu, Qxu, Qxu, Qxu, Qxu, Rr, Rr, Rr, Rr, Qxu, Rr, Qxu, Ql^Bh/, Ur, Ql, Ql, Ql
Qxu, Qxu, Qxu, Uu, Cud, Cud, Cud, Cud, Cud, Uu^Vud, Cud, Cud, Cud, Ur, Ur, Ur, Xu, Cud, Rr, Rr, Rr^Es, Rr, Rr, Rr, Rr, Qxu, Qxu, Qxu, Rr, Rr, Rr, Rr, Rr, Rr, Rr, Ql, Qxu, Ql, Ql
Qxu, Qxu, Qxu, Cud, Cud, Cud, Cud, Cud, Qxu, Cud, Qxu, Uu, Qxu, Qxu, Qxu, Qxu, Xu, Rr, Qxu, Rr, Rr, Rr^Es, Rr, Rr, Rr, Qxu, Rr, Rr, Rr^Es, Rr, Cud, Cud, Cud, Rr, Rr^Es, Ql, Qxu, Qxu, Qxu
Qxu, Qxu, Cud, Cud, Uu^Vud, Cud, Qxu, Qxu, Uu, Qxu, Ur, Qxu, Ur, Uu^Emf, Sm, Uu, Uu^Uf, Xu, Qxu, Rr, Qxu, Rr, Rr, Rr^Vhcr, Rr, Rr, Rr, Rr, Rr, Rr, Cud, 2 Kud, Cud, Rr^Es, Rr^Es, Rr, Rr, Xu, Xu
Qxu, Qxu, Qxu, Cud, Cud, Cud, Qxu, Uu^Emf, Ur^Es, Ur, Ur^Es, Ur, Ur^Es, Ur, Ur, Qxua, Ur, Xu, Xu, Qxu, Qxu, Rr, Rr, Rr, Rr^Es, Rr, Qxu, Qxu, Qxu, Rr, Rr, Cud, Rr, Rr, Rr, Qxu, Rr, Rr^Es, Xu
Qxu, Qxu, Cud, Cud, Cud, Cud, Qxu, Ur, Ur^Es, Ur, Qxua, Ur, Qxua, Ur, Ur^Es, Ur^Es, Ur^Vu, Ur, Ur, Xu, Qxu, Qxu, Rr, Rr^Es, Rr^Es, Rr, Rr, Qxu, Rr, Rr, Rr, Rr, Rr, Rr, Qxu, Qxu, Rr, Rr^Es, Xu
Qxu, Qxu, Qxu, Cud, Cud, Cud, Qxu, Ur, Ur^Es, Ur^Es, Ur, Qxu, Qxua, Qxu, Ur^Es, Ur^Es, Ur^Es, Ur^Es, Ur, Xu, Rr, Qxu, Qxu, Rr, Rr^Es, Rr^Es, Rr, Rr, Rr, Rr^Es, Rr, Rr, Qxu, Rr, Rr, Rr, Rr, Rr, Qxu
Qxua, Qxu, Cud, Cud, Uu^Vud, Cud, Cud, Qxu, Ur, Ur, Cud, Qxu, Qxu, Qxu, Cud, Ur^Es, Cud, Ur, Ur, Xu, Rr, Qxu, Qxu, Rr, Rr, Rr^Es, Rr, Rr^Vhcr, Rr, Rr, Rr, Qxu, Qxu, Qxu, Rr, Rr^Vhcr, Rr, Rr, Qxu
Qxua, Qxu, Qxu, Cud, Cud, Cud, Cud, Cud, Cud, Cud, Uu^Vud, Cud, Qxu, Ur, Ur, Cud, Cud, Cud, Xu, Xu, Rr, Rr, Qxu, Rr, Rr, Rr, Qxu, Rr, Qxu, Rr, Rr, Rr, Qxu, Qxu, Rr, Rr, Rr, Rr, Xu
Qxua, Qxu, Cud, Cud, Cud, Cud, Cud, Cud, Cud, Cud, Cud, Cud, Qxu, Ur, Xu, Ur, Kud, Xu, Rr^Es, Rr^Es, Rr^Vhcr, Rr, Qxu, Qxu, Rr, Rr, Qxu, Qxu, Qxu, Rr, Rr, Qxu, Rr, Rr, Rr, Rr^Es, Rr^Es, Xu, Xu
Ur, Qxu, Qxu, Cud, Uu, Cud, Qxu, Cud, Qxu, Qxu, Qxu, Qxu, Xu, Xu, Ur, Xu, Xu, Xu, Xu, Rr^Es, Rr^Es, Rr^Es, Rr, Rr, Rr^Es, Rr, Rr, Rr, Rr, Rr, Rr, Rr, Rr, Rr, Xu, Rr^Es, Xu, Xu, Qxu
Ur, Ur, Qxu, Uu, Uu^Vud, Uu, Uu, Qxu, Xu, Xu, Xu, Xu, Sm, Ur^Es, Ur, Ur^Es, Uh, Uh, Uh, Xu, Xu, Rr^Es, Rr, Rr^Es, Rr^Es, Rr, Rr, Rr, Xu, Rr^Es, Xu, Rr^Es, Xu, Xu, Sm, Xu, Sm, Qxu, Qxu
Ur^Es, Ur, Qxu, Uu, Uu, Uu, Xu, Xu, Uu, Uu, Uu, Sm, Ur^Es, Ur, Cud, Ur, Ur^Es, Uu, Uu, Uu, Uu, Xu, Xu, Rr^Es, Xu, Rr^Es, Xu, Xu, Sm, Xu, Sm, Xu, Qxu, Qxu, Uu, Sm, Sm, Sm, Qxu
Ur^Es, Ur^Es, Ur, Qxu, Xu, Uu, Xu, Uh, Uu, Uu^Vu, Uu^Es, Ur^Es, Ur^Es, Ur, Ur, Ur, Ur^Es, Uu, Uu, Uu^Vu, Uu, Uu, Xu, Xu, Uu, Xu, Uu, Sm, Uu^Vu, Sm, Sm, Sm, Sm, Uu, Uu^Vu, Uu, Sm, Sm, Qxu
Ur, Ur, Sm, Ur, Ur^Es, Xu, Xu, Uh, Ur^Es, Uu, Ur^Es, Ur, Ur, Ur, Cud, Ur, Ur, Ss, Ss, Uu, Ur^Es, Uh, Xu, Uh, Ur^Es, Uu, Ur^Es, Uu, Uu, Uu, Uu, Uu, Uu, Uu, Uu, Uu, Sm, Qxu, Qxu
Ur, Ur, Sm^Vhs, Ur, Ur^Es, Xu, Ur^Es, Ur^Es, Cud, Ur, Ur^Es, Ur, Ur, Cud, Uu, Cud, Ur, Ur, Ur, Ur, Cud, Ur^Es, Ur^Es, Xu, Ur^Es, Ur^Es, Ur^Es, Ur^Es, Ur^Es, Ur^Es, Ur^Es, Uu^Uf, Uu, Cud, Cud, 3 Kud, Sm, Sm, Qxu
Ur, Ur, Sm, Ur, Ur, Xu, Xu, Ur^Es, Ur, Ur, Ur, Ur^Es, Ur, Cud, Cud, Cud, Ur, Ur^Es, Ur^Es, Ur, Ur^Es, Ur, Xu, Xu, Uu, Ur^Es, Ur^Es, Ur^Es, Ur, Ur^Es, Ur, Ur^Es, Ur^Es, Ur, Ur, Cud, Sm, Sm, Qxu
Ur, Sm, Sm, Sm, Ur, Ur, Xu, Uu, Ur, Ur, Ss, Ur, Ur, Ur, Ur, Ur, Ss, Ur, Ur, Ur, Ur^Es, Uu, Xu, Xu, Xu, Uu, Ur^Es, Ur^Es, Uu, Ur, Uu, Ur^Es, Ur, Ur, Uu, Ur, Ur, Sm, Qxu
Ur, Ur, Sm, Ss, Ss, Ur, Xu, Uu, Uu, Ur, Ur, Ss, Ur^Es, Ur^Es, Ur^Es, Ur, Ss, Ss, Ur, Ur^Es, Uu, Uu, Xu, Qxu, Xu, Uu, Ur^Es, Uu, Xu, Uu, Xu, Uu, Uu, Uu, Uu^Uf, Uu, Ur, Qxu, Qxu
Ur, Ss, Sm, Ss, Ur, Ur, Ur^Es, Xu, Uu, Ur, Uu^Uf, Ur, Ur, Ur, Cud, Ur, Ur, Ur, Ur, Uu, Uu^Uf, Xu, Qxu, Qxu, Qxu, Xu, Xu, Xu, Uu, Xu, Uu, Xu, Xu, Xu, Uu, Uu, Qxu^Bh|, Qxu, Qxu
Ur^Es, Ur, Ss, Ss, Ss^Vhs, Ur, Ur^Es, Xu, Xu, Uu, Uu, Ur^Es, Ur^Es, Ur^Es, Ur, Ur, Ur^Es, Ur^Es, Ur, Uu, Uu, Xu, Qxu, Sm, Qxu^Bs\, Sm, Uu, Ur, Uu^Vu, Uu, Ur, Uu, Uu, Xu, Qxu, Qxu, Ur, Qxu, Qxu
Ur^Es, Ur, Ur, Ss, Sm, Ur^Es, Ur, Ur^Es, Xu, Xu, Xu, Uu, Uu, Ur^Es, Ur^Es, Ur, Ur, Ss, Ur, Ur^Es, Uu, Xu, Xu, Qxu, Sm, Sm, Uu, Ur^Es, Ur^Es, Ur, Cud, Ur, Uu, Xu, Uu, Ur, Uu, Uu, Qxu
Xu, Ur^Es, Xu, Xu, Xu, Sm, Xu, 4 Khw, Chw, Wwf, Wwf, Xu, Xu, Uu, Uu, Uu, Uu, Ur, Ur, Ur^Es, Ur^Es, Uu, Uu, Xu, Xu, Xu, Xu, Uu, Uu, Ur, Ur, Ur, Sm, Xu, Uu, Ur^Es, Qxu, Uu^Vu, Qxu
Wwg, Xu, Wwg, Ur, Ur, Xu, Ww, Chw, Ww, Ww, Wwf, Ss, Ss, Xu, Xu, Xu, Xu, Uu, Ur^Es, Ur^Es, Ur, Ur, Ur, Uu, Uu, Uu, Uu, Xu, Xu, Sm, Sm, Sm, Qxu, Xu, Uu, Ur, Qxu, Qxu, Qxu
Wo, Wwg, Ww, Wwg, Wwg, Xu, Ww, Ww, Ww, Ww, Dd, Ww, Ss, Ss, Ss, Ss, Xu, Uu, Uu, Ur, Ur, Ss, Ss, Ur, Ur^Es, Ur^Es, Ur^Es, Uu, Uu, Xu, Xu, Sm, Qxu, Xu, Qxu, Qxu^Bh|, Qxu, Qxu, Xu
Wo, Ww, Ww, Ww, Wwf, Xu, Xu, Ww, Dd, Ww, Dd, Ss, Ww, Ww, Ww, Ss, Ss, Xu, Xu, Uu, Uu, Ur, Ur, Ur, Ur^Es, Ur^Es, 1 Ur, Ur^Es, Ur, Uu, Uu, Xu, Xu, Qxu, Qxu, Ur, Uu, Xu, Xu
Wo, Wo, Dd, Chw, Dd, Wwf, Ww, Ww, Dd, Dd, Dd^Es, Dd, Dd, Dd, Wwg, Wwg, Ss, Ss, Xu, Uu, Uu, Ur, Ur, Ur^Es, Ur, Ur, Ur, Ur, Ur^Es, Ur, Uu, Uh, Uh, Xu, Uu, Ur^Es, Ur^Es, Uu, Xu
Wo, Wo, Ww^Vm, Dd, Wwf, Dd, Ww, Ww, Dd, Dd^Vdt, Dd^Vdt, Dd, Dd, Chw, Ss, Ww, Wwg, Ss, Ss, Xu, Uh, Uu, Uu, Ur^Es, Ur^Es, Ur, Ur, Ur, Ur, Ur, Ur^Es, Uh, Md, Xu, Xu, Uu, Cud, Uu, Xu
Wo, Wo, Ww, Wwf, Wwf, Ww, Ww, Dd, Dd, Dd^Es, Dd, Dd, Dd, Ss, Ww, Ww, Ss, Ss^Vhs, Ss, Xu, Xu, Uh, Xu, Uu, Uu, Uu, Uu, Uu, Uh, Uh, Rd, Hd, Hd, Md, Xu, Uu, Sm, Sm, Xu
Wo, Ww, Wwg, Wwg, Dd, Dd, Dd, Dd, Dd, Dd, Dd, Dd, Ss, Ss, Ss, Ww, Ss, Ss, Xu, Xu, Xu, Xu, Xu, Xu, Xu, Xu, Xu, Xu, Xu, Hd, Rd, Dd^Esd, Hd, Md, Md, Xu, Xu, Xu, Xu
