border_size=1
usage=map

Ss, Ss, Ss, Ss, Ss, Ss, Ss, Ss, Ss, Ss, Ss, Ss, Ss, Ss, Ww, Dd, Dd, Dd, Rp, Rp, Aa, Rp, Aa^Voa, Aa, Aa, Aa, Rp, Rp
Ss, Ss, Ss, Ss, Ss, Ss, Ss, Ss, Gs, Ss, Gs, Ss, Ss, Ww, Ww, Wwf, Dd, Dd, Co, Rp, Rp, Aa, Aa, Rp, Rp, Aa, Rp, Rp
Gs, Gs, Gs, Ss, Ss, Ss, Ss, Gs, Gs, Gs, Gs, Gs, Ss, Ss, Ww, Wwf, Dd, Dd, Co, 4 Ko, Co, Rp, Rp, Rp, Co, Rp, Rp, Rr
Gs, Gs, Ss, Ss, 2 Kh, Ss, Ss, Ss, Gs, Aa, Gs, Ss^Vo, Ss, Ss, Ww, Dd, Dd^Vo, Dd, Rp, Co, Rp, Rp, Rp, Co, 3 Ko, Co, Rp, Rp
Ss, Gs, Gs, Ss, Ss, Ss, Ss, Gs, Aa, Aa, Aa, Gs, Ss, Gs^Ft, Dd^Es, Dd^Es, Dd, Dd, Rp, Rp, Rp, Rp, Rp, Co, Co, Co, Rp, Rp
Ss, Gs, Gs, Ss, Gs, Ss, Gs, Gs, Gs, Aa, Gs, Gs, Gs^Ft, Gs, Gs^Ft, Dd^Es, Dd, Dd, Co, Rp, Rp, Rp, Rp, Rp, Rp, Rp, Aa, Rp
Gs, Ss, Ss, Gs, Gs, Gs, Gs^Vo, Gs, Gd, Gs, Gs, Gs, Gs^Ft, Gs^Ft, Gs^Ft, Dd, Rd, Rd, Dd, Rp, Rp, Co, 5 Ko, Rp, Rp, Aa, Rp, Aa
Gs, Gs, Gs, Gs, Aa, Gs, Dd, Dd^Ftd, Dd^Ftd, Gd, Gs, Gs, Gs, Gs^Ft, Re, Re, Gd, Aa, Aa, Dd, Dd, Co, Co, Co, Rp, Rp, Aa, Rp
Gs^Fmw, Gs, Gs, Aa, Ha, Aa, Aa, Dd, Dd, Gd, Aa, Gs, Re, Aa, Gd, Gd, Gd, Aa, Dd, Dd^Vo, Dd, Dd, Dd, Rp, Rp, Rp, Rp, Rp
Gs^Fmw, Gs^Fmw, Gs, Aa, Aa, Aa, Dd, Dd^Es, Gd, Gd, Aa, Re, Gs, Gd, Dd, Dd, Gd, Dd, Gd, Dd, Dd, Dd, Dd, Dd, Dd, Co, Rp, Rp
Aa^Fmw, Gs^Vht, Gs, Gd, Dd, Dd, Dd^Es, Gd^Es, Gs, Re, Aa, Aa, Aa, Gd, Gd, Dd, Gd^Es, Gd^Es, Dd^Es, Gd, Gd, Dd, Gd, Dd, Dd, Aa, Aa, Rp
Aa, Aa, Gs, Gd, Gd, Gd, Gd, Gd^Es, Gs, Gs, Aa, Aa^Fmw, Gd^Fmw, Gd^Vo, Hh, Gd, Dd^Es, Dd, Dd, Gd, Aa, Gd, Re^Gvs, Gd, Gd, Dd, Aa, Aa
Ha, Aa, Gs^Es, Gs, Re, Re, Aa, Re, Gs, Aa, Aa^Fmw, Gd^Fmw, Gd^Es, Gd^Fmw, Hh, Gd, Gd, Gd, Gd, Gd, Gs, Gg, Gg, Re^Gvs, Gd, Dd, Dd, Aa
Aa, Ha, Aa, Re, Gs, Aa, Gs, Gs, Ww, Ai, Aa^Fmw, Gd^Es, Gd^Fmw, Gd^Fmw, Gs^Fmw, Gs, Gs, Gs^Fmw, Gs^Fmw, Gs^Fmw, Aa, Gs, Aa, Gg, Gs, Gd, Gd^Es, Dd
Aa, Aa, Gd, Gd, Gs, Gg^Vo, Gs, Ww, Ww, Gs, Gs, Gs, Gs, Gs, Ww, Wwf, Gs, Gs^Fmw, Aa^Fmw, Aa^Fmw, Aa, Aa^Voa, Aa, Gs, Gs, Gs, Gs, Gd^Es
Aa, Gd, Gd^Es, Dd, Gs, Gs, Aa, Gs, Gs, Ww, Ww, Gs, Gs, Gs, Gs^Ft, Ww, Gs, Gs^Fmw, Gs^Fmw, Aa^Fmw, Aa, Ha, Aa, Aa^Fmw, Gs^Fmw, Gs^Fmw, Gs^Fmw, Gg
Gd, Gd, Gd^Es, Gd, Gd^Fmw, Aa^Fmw, Aa, Gs^Fmw, Gs, Wwf, Gs, Gs, Aa, Gg^Vo, Gs^Ft, Wwf, Ww, Gg, Gs, Aa, Aa, Ha, Aa^Fmw, Aa^Fmw, Gs^Fmw, Gs^Fmw, Gs, Gg
Gd, Dd^Es, Gd, Gd, Gd, Gd^Fmw, Aa, Aa, Aa, Gs, Gs, Aa, Aa, Gs, Gs, Gs^Ft, Ww, Ww, Gs, Gs, Gs, Aa, Gg^Fmw, Gs^Fmw, Gs^Fmw, Gs^Fmw, Gs^Fmw, Gg
Gd, Dd, Gd, Dd, Gd, Gd, Gd, Aa, Gs, Gs, Gd^Fmw, Gd^Fmw, Gd, Gs, Gd^Fmw, Gs, Gs, Gs, Gs^Fmw, Gg, Gs, Gs, Gs, Gs, Gs, Gs^Vo, Gs, Gg
Aa, Gd, Aa, Dd, Dd, Dd, Gd, Gs, Gd, Gs, Gd, Gd, Dd^Es, Gd, Gs, Gs, Gs, Gs^Fmw, Gs^Fmw, Gs^Fmw, Gs, Gs, Aa, Gs, Gs, Gs, Aa, Aa
Aa, Aa, Dd, Dd, Dd^Vdt, Dd, Dd^Es, Gd, Gd^Es, Gd, Gd^Es, Gd^Es, Gd^Es, Gd, Gg^Vo, Gs, Gs, Gs^Fmw, Gs^Fmw, Aa^Fmw, Gs, Aa, Aa, Aa, Gs, Gs, Aa, Ha
Dd, Aa, Dd, Dd^Edp, Dd^Edp, Dd, Dd, Gd^Es, Dd^Es, Gd^Es, Dd, Dd, Aa, Gd, Gg, Gs, Aa, Gs, Aa^Fmw, Aa, Aa, Gs, Gs, Gs, Gd, Gd, Gd, Aa
Aa, Aa, Aa, Dd, Dd, Dd, Hd, Dd, Dd^Es, Dd, Ha, Aa, Dd, Gd, Gd, Gs, Aa, Aa, Aa, Aa, Aa, Gs, Gs^Vc, Gs, Gd^Es, Dd^Es, Dd, Gd
Ha, Ha, Ha, Ha, Hd, Hd, Ce, Ce, Ce, Hd, Dd, Aa, Dd, Gd, Dd^Es, Gd, Gd, Gd, Gd, Aa, Gd, Gd, Gd, Gd, Dd^Es, Dd, Aa, Gd
Ha, Ha, Ha, Md, Md, Hd, Ce, 1 Ke, Ce, Hd, Hd, Dd, Dd^Edpp, Dd, Dd^Dc, Dd^Es, Dd^Es, Dd^Es, Gd^Es, Gd, Gd, Dd^Es, Gd^Es, Gd, Dd, Dd, Aa, Aa
Ms, Md, Mm, Md, Md, Ha, Ha, Ce, Dd, Dd^Vdt, Hd, Hd, Hd, Dd, Dd, Dd, Dd^Vda, Dd, Dd, Dd, Dd, Gd, Gd, Dd^Es, Dd, Aa, Aa, Ha
Ms, Ms, Ms, Mm, Md, Md, Ha, Dd, Hd, Dd^Edp, Dd, Ha, Ha, Aa, Dd, Dd^Edpp, Dd^Edpp, Dd, Ha, Aa, Dd, Dd^Es, Gd, Dd^Es, Gd, Gd, Aa, Ha
Ms, Ms, Ms, Ms, Ms, Md, Md, Ha, Hd, Dd, Dd, Aa, Aa, Ha, Hd, Dd^Edpp, Ds, Dd, Ds, Ha, Hd, Dd, Ds, Gd, Gd, Gd, Gd, Aa
