border_size=1
usage=map

Ss, Ss, Ss, Ss, Ss, Ss, Ss, Ss, Ss, Ss, Ss, Ss, Ss, Ss, Ww, Ds, Ds, Ds, Rp, Rp, Rp, Rp, Rp, Rp, Rp, Rp, Rp, Rp
Ss, Ss, Ss, Ss, Ss, Ss, Ss, Ss, Gs, Ss, Gs, Ss, Ss, Ww, Ww, Wwf, Ds, Ds, Ch, Rp, Rp, Rp, Rp, Rp, Rp, Rp, Rp, Rp
Gs, Gs, Gs, Ss, Ss, Ss, Ss, Gs, Gs, Gs, Gs, Gs, Ss, Ss, Ww, Wwf, Ds, Ds, Ch, 4 Kh, Ch, Rp, Rp, Rp, Ch, Rp, Rp, Rr
Gs, Gs, Ss, Ss, 2 Kh, Ss, Ss, Ss, Gs, Gg, Gs, Ss^Vo, Ss, Ss, Ww, Ds, Dd^Vo, Ds, Rp, Ch, Rp, Rp, Rp, Ch, 3 Kh, Ch, Rp, Rp
Ss, Gs, Gs, Ss, Ss, Ss, Ss, Gs, Gs, Gg, Gs, Gs, Ss, Gs^Ft, Ds, Ds, Ds, Ds, Rp, Rp, Rp, Rp, Rp, Ch, Ch, Ch, Rp, Rp
Ss, Gs, Gs, Ss, Gs, Ss, Gs, Gs, Gs, Gd, Ds, Gs, Gs^Ft, Gs, Gs^Ft, Ds, Ds, Ds, Ch, Rp, Rp, Rp, Rp, Rp, Rp, Rp, Rp, Rp
Gs, Ss, Ss, Gs, Gs, Gs, Gg^Vo, Gs, Gd, Ds, Gd, Gs, Gs^Ft, Gs^Ft, Gs^Ft, Ds, Rd, Rd, Ds, Rp, Rp, Ch, 5 Kh, Rp, Rp, Rp, Rp, Rp
Gs, Gs, Gs, Gs, Gs, Gg, Ds, Ds, Ds, Gd, Gg, Gg, Gg, Gs^Ft, Re, Re, Gd, Ds, Ds, Ds, Ds, Ch, Ch, Ch, Rp, Rp, Rp, Rp
Gs^Fmw, Gs, Gg, Gs, Gd, Gd, Ds, Dd^Edp, Ds, Gd, Gg, Gg, Re, Gg, Gd, Gd, Gd, Gd, Ds, Dd^Vo, Ds, Ds, Ds, Rp, Rp, Rp, Rp, Rp
Gs^Fmw, Gs^Fmw, Gg, Gd, Ds, Gd, Ds, Ds, Gd, Gd, Gg, Re, Gg, Gd, Ds, Ds, Gd, Ds, Gd, Ds, Ds, Ds, Ds, Ds, Ds, Ch, Rp, Rp
Gs^Fmw, Gs^Fmw, Gg, Gd, Ds, Ds, Ds, Gd, Gg, Re, Gg, Gg, Gg, Gd, Gd, Ds, Gd, Gd, Ds, Gd, Gd, Ds, Gd, Ds, Ds, Ds, Ds, Rp
Gg, Gg, Gg^Vo, Gd, Gd, Gd, Gd, Gd, Re, Gg, Gg, Gs^Fmw, Gs^Fmw, Gg^Vo, Gd^Fmw, Gd, Ds, Ds, Ds, Gd, Gd, Gd, Re^Gvs, Gd, Gd, Ds, Ds, Ds
Gg, Gg, Gg, Gg, Re, Re, Gg, Re, Gg, Gg, Gs^Fmw, Gs^Fmw, Gs^Fmw, Gs^Fmw, Gs^Fmw, Gd, Gd, Gd, Gd, Gd, Gg, Gg, Gg, Re^Gvs, Gd, Ds, Ds, Ds
Gg, Gg, Gg, Re, Gg, Gg, Gg, Gg, Ww, Gg, Gg^Fmw, Gg, Gs^Fmw, Gs^Fmw, Gg, Gg, Gg, Gs^Fmw, Gs^Fmw, Gs^Fmw, Gg, Gg, Gg, Gg, Gg, Gd, Gd, Ds
Gg, Gg, Gd, Gd, Gg, Gg^Vo, Gg, Ww, Ww, Gg, Gg, Gg, Gg, Gg, Ww, Wwf, Gg, Gs^Fmw, Gs^Fmw, Gs^Fmw, Gg, Gg^Vo, Gg, Gg, Gg, Gg, Gg, Gd
Gd, Gd, Gd, Ds, Gg, Gg, Gg, Gg, Gg, Ww, Ww, Gg, Gg, Gg, Gs^Ft, Ww, Gg, Gs^Fmw, Gs^Fmw, Gs^Fmw, Gg, Gg, Gg, Gs^Fmw, Gs^Fmw, Gs^Fmw, Gs^Fmw, Gg
Gd, Gd, Gd, Gd, Gd^Fmw, Gd^Fmw, Gg, Gs^Fmw, Gg, Wwf, Gg, Gg, Gg, Gg^Vo, Gs^Ft, Wwf, Ww, Gg, Gg, Gg, Gs, Gg, Gs^Fmw, Gs^Fmw, Gs^Fmw, Gs^Fmw, Gg, Gg
Gd, Ds, Gd, Gd, Gd, Gd^Fmw, Gg, Gg, Gg, Gg, Gg, Gg, Gg, Gg, Gg, Gs^Ft, Ww, Ww, Gg, Gs, Gs, Gg, Gg^Fmw, Gs^Fmw, Gs^Fmw, Gs^Fmw, Gs^Fmw, Gg
Gd, Ds, Gd, Ds, Gd, Gd, Gd, Gg, Gg, Gg, Gd^Fmw, Gd^Fmw, Gd, Gg, Gd^Fmw, Gg, Gg, Gg, Gs^Fmw, Gg, Gg, Gg, Gs, Gg, Gg, Gg^Vo, Gg, Gg
Gd, Gd, Gd, Ds, Ds, Ds, Gd, Gg, Gd, Gg, Gd, Gd, Ds, Gd, Gg, Gg, Gg, Gs^Fmw, Gs^Fmw, Gs^Fmw, Gg, Gs, Gs, Gs, Gg, Gg, Gg, Gg
Gd, Gd, Ds, Ds, Dd^Vdt, Ds, Ds, Gd, Gd, Gd, Gd, Gd, Gd, Gd, Gg^Vo, Gg, Gg, Gs^Fmw, Gs^Fmw, Gs^Fmw, Gg, Gs, Gs, Gs, Gs, Gg, Gg, Gg
Ds, Gd, Ds, Ds^Edp, Ds^Edp, Ds, Ds, Gd, Ds, Gd, Ds, Ds, Gd, Gd, Gg, Gg, Gg, Gg, Gs^Fmw, Gg, Gg, Gg, Gs, Gs, Gd, Gd, Gd, Gg
Hd, Ds, Ds, Ds, Ds, Ds, Hd, Ds, Ds, Ds, Hd, Ds, Ds, Gd, Gd, Gg, Gg, Gg, Gg, Gg, Gg, Gg, Gg^Vc, Gg, Gd, Ds, Ds, Gd
Md, Hd, Hd, Hd, Hd, Hd, Ce, Ce, Ce, Hd, Ds, Ds, Ds, Gd, Ds, Gd, Gd, Gd, Gd, Gg, Gd, Gd, Gd, Gd, Ds, Ds, Gd, Gd
Md, Md, Md, Md, Md, Hd, Ce, 1 Ke, Ce, Hd, Hd, Ds, Ds, Ds, Dd^Dc, Ds, Ds, Ds, Gd, Gd, Gd, Ds, Gd, Gd, Ds, Dd, Ds, Gd
Mm, Md, Mm, Md, Md, Hd, Hd, Ce, Ds, Dd^Vdt, Hd, Hd, Hd, Ds, Ds^Edp, Ds, Dd^Vda, Ds, Ds, Gd, Ds, Gd, Gd, Ds, Ds, Ds, Ds, Gd
Md^Xm, Mm, Mm, Mm, Md, Md, Hd, Ds, Hd, Ds^Edp, Ds, Hd, Hd, Ds, Ds, Ds, Ds, Ds, Hd, Ds, Ds, Ds, Gd, Ds, Gd, Gd, Gd, Gd
Md^Xm, Mm, Md^Xm, Mm, Mm, Md, Md, Hd, Hd, Ds, Ds, Ds, Ds, Hd, Hd, Ds, Ds, Ds, Ds, Hd, Hd, Ds, Ds, Gd, Gd, Gd, Gd, Gd