border_size=1
usage=map

Ss, Ss, Ss, Ss, Ss, Ss, Ss, Ss, Ss, Ss, Ss, Ss, Ss, Ss, Ww, Dd, Dd, Dd, Rp, Rp, Aa, Rp, Aa, Aa, Aa, Aa, Rp, Rp
Ss, Ss, Ss, Ss, Ss, Ss, Ss, Ss, Gs, Ss, Gs, Ss, Ss, Ww, Ww, Wwf, Dd, Dd, Cd, Rp, Rp, Aa, Aa, Rp, Rp, Aa, Rp, Rp
Gs, Gs, Gs, Ss, Ss, Ss, Ss, Gs, Gs, Gs, Gs, Gs, Ss, Ss, Ww, Wwf, Dd, Dd, Cd, 4 Kd, Cd, Rp, Rp, Rp, Cd, Rp, Rp, Rr
Gs, Gs, Ss, Ss, 2 Kh, Ss, Ss, Ss, Gs, Aa, Gs, Ss^Vo, Ss, Ss, Ww, Dd, Dd^Vo, Dd, Rp, Cd, Rp, Rp, Rp, Cd, 3 Kd, Cd, Rp, Rp
Ss, Gs, Gs, Ss, Ss, Ss, Ss, Gs, Aa, Aa, Aa, Gs, Ss, Gs^Ft, Dd, Dd, Dd, Dd, Rp, Rp, Rp, Rp, Rp, Cd, Cd, Cd, Rp, Rp
Ss, Gs, Gs, Ss, Gs, Ss, Gs, Gs, Gs, Aa, Gs, Gs, Gs^Ft, Gs, Gs^Ft, Dd, Dd, Dd, Cd, Rp, Rp, Rp, Rp, Rp, Rp, Rp, Aa, Rp
Gs, Ss, Ss, Gs, Gs, Gs, Gs^Vo, Gs, Gd, Gs, Gs, Gs, Gs^Ft, Gs^Ft, Gs^Ft, Dd, Rd, Rd, Dd, Rp, Rp, Cd, 5 Kd, Rp, Rp, Aa, Rp, Aa
Gs, Gs, Gs, Gs, Aa, Gs, Dd, Dd^Ftd, Dd^Ftd, Gd, Gs, Gs, Gs, Gs^Ft, Re, Re, Gd, Aa, Aa, Dd, Dd, Cd, Cd, Cd, Rp, Rp, Aa, Rp
Gs^Fmw, Gs, Gs, Aa, Aa, Aa, Aa, Dd, Dd, Gd, Aa, Gs, Re, Aa, Gd, Gd, Gd, Aa, Dd, Dd^Vo, Dd, Dd, Dd, Rp, Rp, Rp, Rp, Rp
Gs^Fmw, Gs^Fmw, Gs, Aa, Aa, Aa, Dd, Dd, Gd, Gd, Aa, Re, Gs, Gd, Dd, Dd, Gd, Dd, Gd, Dd, Dd, Dd, Dd, Dd, Dd, Cd, Rp, Rp
Aa^Fmw, Gs^Vht, Gs, Gd, Dd, Dd, Dd, Gd, Gs, Re, Aa, Aa, Aa, Gd, Gd, Dd, Gd, Gd, Dd, Gd, Gd, Dd, Gd, Dd, Dd, Aa, Aa, Rp
Aa, Aa, Gs, Gd, Gd, Gd, Gd, Gd, Gs, Gs, Aa, Aa^Fmw, Gs^Fmw, Gg^Vo, Gd^Fmw, Gd, Dd, Dd, Dd, Gd, Aa, Gd, Re^Gvs, Gd, Gd, Dd, Aa, Aa
Aa, Gs, Gs, Gs, Re, Re, Aa, Re, Gs, Aa, Aa^Fmw, Gs^Fmw, Gs^Fmw, Gs^Fmw, Gs^Fmw, Gd, Gd, Gd, Gd, Gd, Gs, Gg, Gg, Re^Gvs, Gd, Dd, Dd, Aa
Aa, Gs, Aa, Re, Gs, Aa, Gs, Gs, Ww, Ai, Aa^Fmw, Gs, Gs^Fmw, Gs^Fmw, Gs, Gs, Gs, Gs^Fmw, Gs^Fmw, Gs^Fmw, Aa, Gs, Aa, Gg, Gs, Gd, Gd, Dd
Aa, Aa, Gd, Gd, Gs, Gg^Vo, Gs, Ww, Ww, Gs, Gs, Gs, Gs, Gs, Ww, Wwf, Gs, Gs^Fmw, Aa^Fmw, Aa^Fmw, Aa, Aa^Voa, Aa, Gs, Gs, Gs, Gs, Gd
Aa, Gd, Gd, Dd, Gs, Gs, Aa, Gs, Gs, Ww, Ww, Gs, Gs, Gs, Gs^Ft, Ww, Gs, Gs^Fmw, Gs^Fmw, Aa^Fmw, Aa, Aa, Aa, Aa^Fmw, Gs^Fmw, Gs^Fmw, Gs^Fmw, Gg
Gd, Gd, Gd, Gd, Gd^Fmw, Aa^Fmw, Aa, Gs^Fmw, Gs, Wwf, Gs, Gs, Aa, Gg^Vo, Gs^Ft, Wwf, Ww, Gg, Gs, Aa, Aa, Aa, Aa^Fmw, Aa^Fmw, Gs^Fmw, Gs^Fmw, Gs, Gg
Gd, Dd, Gd, Gd, Gd, Gd^Fmw, Aa, Aa, Aa, Gs, Gs, Aa, Aa, Gs, Gs, Gs^Ft, Ww, Ww, Gs, Gs, Gs, Aa, Gg^Fmw, Gs^Fmw, Gs^Fmw, Gs^Fmw, Gs^Fmw, Gg
Gd, Dd, Gd, Dd, Gd, Gd, Gd, Aa, Gs, Gs, Gd^Fmw, Gd^Fmw, Gd, Gs, Gd^Fmw, Gs, Gs, Gs, Gs^Fmw, Gg, Gs, Gs, Gs, Gs, Gs, Gs^Vo, Gs, Gg
Aa, Gd, Aa, Dd, Dd, Dd, Gd, Gs, Gd, Gs, Gd, Gd, Dd, Gd, Gs, Gs, Gs, Gs^Fmw, Gs^Fmw, Gs^Fmw, Gs, Gs, Aa, Gs, Gs, Gs, Aa, Aa
Aa, Aa, Dd, Dd, Dd^Vdt, Dd, Dd, Gd, Gd, Gd, Gd, Gd, Gd, Gd, Gg^Vo, Gs, Gs, Gs^Fmw, Gs^Fmw, Aa^Fmw, Gs, Aa, Aa, Aa, Gs, Gs, Aa, Aa
Dd, Aa, Dd, Dd^Edp, Dd^Edp, Dd, Dd, Gd, Dd, Gd, Dd, Dd, Aa, Gd, Gg, Gs, Aa, Gs, Aa^Fmw, Aa, Aa, Gs, Gs, Gs, Gd, Gd, Gd, Aa
Aa, Aa, Aa, Dd, Dd, Dd, Hd, Dd, Dd, Dd, Ha, Aa, Dd, Gd, Gd, Gs, Aa, Aa, Aa, Aa, Aa, Gs, Gs^Vc, Gs, Gd, Dd, Dd, Gd
Ha, Ha, Ha, Ha, Hd, Hd, Ce, Ce, Ce, Hd, Dd, Aa, Dd, Gd, Dd, Gd, Gd, Gd, Gd, Aa, Gd, Gd, Gd, Gd, Dd, Dd, Aa, Gd
Ha, Ha, Ha, Md, Md, Hd, Ce, 1 Ke, Ce, Hd, Hd, Dd, Dd^Edpp, Dd, Dd^Dc, Dd, Dd, Dd, Gd, Gd, Gd, Dd, Gd, Gd, Dd, Dd, Aa, Gd
Ms, Md, Mm, Md, Md, Ha, Ha, Ce, Dd, Dd^Vdt, Hd, Hd, Hd, Dd, Dd, Dd, Dd^Vda, Dd, Dd, Dd, Dd, Gd, Gd, Dd, Dd, Aa, Aa, Gd
Ms, Ms, Ms, Mm, Md, Md, Ha, Dd, Hd, Dd^Edp, Dd, Ha, Ha, Aa, Dd, Dd^Edpp, Dd^Edpp, Dd, Ha, Aa, Dd, Dd, Gd, Dd, Gd, Gd, Aa, Gd
Ms, Ms, Ms, Ms, Ms, Md, Md, Ha, Hd, Dd, Dd, Aa, Aa, Ha, Hd, Dd^Edpp, Ds, Dd, Ds, Ha, Hd, Dd, Ds, Gd, Gd, Gd, Gd, Gd