border_size=1
usage=map

Ds, Ds^Es, Ds, Ds^Es, Ds, Dd^Dc, Ds, Ds, Ss, Ww, Ss, Ww, Ss, Ww, Ss, Ww, Ss, Gs, Gs, Ds, Ds, Ds, Ds, Rd, Ds, Gs, Gs^Vo, Gs, Ss, Ss, Ww, Ww, Ss, Gs^Vht, Gs, Gd, Dd, Dd, Dd^Es, Dd, Dd, Gd, Gs, Gs^Fms, Gs^Fms, Gs^Fp, Gg^Efm, Gg^Efm, Gs^Fp, Gg^Efmy, Gg^Efmy, Gg
Ds, Ds, Ss, Ds, Ss, Ss, Ss, Ss, Ss, Ss, Gs, Ss, Gs, Ss, Gs, Ss, Gs, Ss, Ss, Gs, Gs, Co, Gd, Rd, Gd, Gs, Ss, Ss, Ss, Ss, Ww, Ss, Gs, Gs, Gs, Dd, Hd^Es, Hd, Dd^Es, Dd^Es, Dd, Gd, Gs^Vht, Gs, Ce, Gs^Fp, Gg^Efm, Gs^Fp, Gs, Gs, Gg^Efmy, Gg
Ss, Ss, Ss, Ss, Gs, Gs, Gd, Gs, Gd, Gs, Gd, Gs, Gd, Gs, Gd, Gs, Gd, Gs, Gs, Ss, Ss, Gs, Rd, Rd, Ss, Ss, Gs, Gs, Ss, Gs^Ft, Ww, Ss, Dd, Gs, Dd^Es, Dd, Dd, Dd^Es, Dd, Dd^Es, Dd, Gd, Gd, Gs, Gs^Fms, Gs^Fms, Ce, Gs^Fp, Gs^Fp, Gs, Gs, Gg
Ss, Ss, Gs, Ss, Gs, Gd, Dd, Gd, Dd, Gd, Dd, Gd, Dd, Gd^Es, Dd^Es, Gd^Es, Dd, Gd, Gd, Gs, Gs, Ss, Rd, Ss, Gs, Gs, Gs, Gs, Gs^Ft, Gs^Ft, Ww, Dd^Ftd, Dd^Ftd, Dd, Dd^Es, Gd, Dd, Dd^Vdt, Dd, Gd^Es, Gd^Es, Dd^Es, Gd, Ce, Gs, Ce, 3 Ke, Ce, Gs^Fp, Gs, Gs^Fp, Gs
Gs, Gs, Ss, Ss, Gs, Gd, Dd, Dd, Dd^Vo, Rd, Rd, Rd, Dd^Vo, Rd, Rd, Rd, Dd^Vo, Dd, Dd, Gd, Gd, Rd, Gd, Gd, Dd, Dd^Es, Gd^Es, Gs, Dd^Ftd, Dd^Ftd, Ww, Dd^Ftd, Dd, Dd, Gd^Es, Gd, Gd, Dd, Gd, Gd, Gd, Dd^Es, Gd, Ce, Gs, Ce, Ce, Ce, Gs, Gg^Ve, Gs^Fms, Gs
Gs, Gs, Ss, Gs, Gd, Gd^Es, Dd, Dd, Dd, Dd, Rd, Dd, Dd^Es, Dd, Rd, Dd, Dd, Dd, Dd^Es, Dd, Rd, Rd, Dd, Dd, Dd^Vo, Dd, Dd, Dd, Dd, Dd^Ftd, Ww, Dd^Ftd, Dd, Dd^Es, Dd, Gd^Es, Gd^Es, Gd, Dd^Es, Gd, Gs, Gd, Gs, Ce, Gg^Efm, Gs, Gs, Gs, Gs, Gs, Gs, Gs
Gs, Gs, Ss, Gs, Gd^Es, Dd, Dd^Es, Dd^Es, Rd, Rd, Dd^Es, Rd, Rd, Rd, Dd^Es, Rd, Rd, Dd^Es, Dd, Dd, Rd, Dd, Dd, Dd, Dd, Dd, Dd, Co, Dd, Dd^Ftd, Ww, Dd, Dd^Vda, Dd, Hd^Es, Dd, Dd^Es, Dd^Es, Gd^Es, Gd, Gs^Fms, Gs, Gg, Gs^Fms, Gs^Fms, Gg^Efm, Ce, Ce, Ce, Gs, Gs^Fp, Gs
Gs, Ss, Ss, Gs, Gd^Es, Dd^Es, Dd, Dd, Co, Dd, Dd^Es, Dd^Es, Dd^Es, Dd^Es, Dd, Dd, Co, Dd, Dd, Rd, Dd, Dd, Dd^Es, Dd, Co, Dd, Dd^Es, Dd, Dd, Ww, Dd^Ftd, Dd, Dd, Dd, Hd^Es, Dd, Gd, Dd, Gd, Gs^Fms, Gs, Gs, Gs, Ce, Gs^Fms, Gs^Fms, Ce, 2 Ke, Ce, Gs, Gs, Gs^Fp
Gs, Ss, Ss, Gs, Gd, Dd, Rp, Rp, Rp, Rp, Rp, Rp, Rp, Rp, Rp, Rp, Rp, Rp, Rp, Rd, Dd, Dd^Es, Dd, Dd, Co, Dd, Dd^Es, Dd^Es, Dd, Ww, Dd^Ftd, Dd, Dd^Ftd, Dd, Dd, Dd, Gd, Gd, Gs^Fms, Gs, Re^Gvs, Re^Gvs, Gs, Gs, Gs, Gs, Gs, Ce, Gs, Gs, Gd, Gs
Ss, Ss, Ss, Gs, Gd, Dd, Rp, Rp, Rp, Rp, Rp, Rp, Rp, Rp, Rp, Rp, Rp, Rp, Rp, Rp, Co, Dd, Dd, Rd, Dd, Dd, Dd, Dd, Ss, Ww, Dd^Ftd, Dd^Ftd, Dd^Ftd, Gs, Gs, Gd, Gd, Gs, Gd, Gs, Gs, Re^Gvs, Gs, Ce, Gd, Gs, Ce, Gd, Gs, Gd, Dd^Ftd, Gd
Ss, Ss, Ww, Ww, Wwf, Dd, Dd, Rp, Rp, Rp, Rp, Rp^Vo, Rp, Rp, Rp, Rp, Rp, Rp, Rp, Rp, Rp, Rp, Rd, Rd, Dd, Dd^Es, Dd, Co, Ss, Ww, Dd^Ftd, Dd, Dd^Es, Dd^Ftd, Gs, Gd, Dd, Gd, Dd^Es, Gd, Gd, Gs, Gs, Ce, Gs, Gd, Gd, Gd, Gd, Gs, Gd, Dd^Ftd
Gg, Ss, Ss, Ww, Wwf, Dd, Dd, Co, Ko, Rp, Rp, Rp, Rp, Rp, Rp, Rp, Rp, Rp, Rp, Rp, Rp, Rp, Rp, Dd, Dd^Vo, Dd, Dd, Dd^Ftd, Ww, Ww, Dd^Vda, Dd^Es, Dd^Es, Dd, Gd, Gd, Dd^Es, Dd, Dd^Es, Gd^Vht, Gd, Gd, Gd, Ce, Gs, Gd, Ce, 4 Ke, Gd, Gs, Gs, Dd^Ftd
Gg, Ss, Ss, Ww, Dd, Dd, Dd, Co, Co, Co, Rp, Rp, Co, Co, Co, Rp, Rp, Rp, Rp, Rp, Rp^Vo, Rp, Rp, Dd, Dd^Es, Dd, Dd^Ftd, Gs^Ft, Ww, Dd^Ftd, Dd^Ftd, Dd, Gd, Gd, Gd, Dd, Dd^Es, Dd^Es, Gd, Gd, Gs^Fms, Gs, Gd, Gg^Wm, Gs, Ce, Ce, Gd, Dd, Gd, Gs, Gd
Gg, Ss, Gs^Ft, Ww, Dd, Dd^Vo, Dd, Rp, Rp, Rp, Rp, Rp, Co, 1 Kh, Ch, Rp, Rp, Rp, Rp, Rp, Rp, Rp, Rp, Dd, Dd, Dd, Gs^Ft, Gs^Ft, Ww, Dd^Ftd, Dd, Dd, Gd, Gd, Dd, Dd, Dd, Gd, Gs^Fms, Gs^Fms, Gs, Gs, Gs, Gd, Ce, Gs, Dd, Ce, Dd, Ce, Gs, Gs
Gg, Ss, Gs^Ft, Dd, Dd, Dd^Es, Dd^Es, Rp, Rp, Rp, Rp, Rp, Rp, Co, Rp, Rp, Rp, Rp, Rp, Rp, Rp, Rp, Dd, Co, Dd, Dd, Gs^Ft, Ww, Dd^Ftd, Dd^Ftd, Dd^Es, Dd^Es, Gd, Dd, Dd, Dd^Vdt, Dd, Gd, Gd, Gs^Fms, Gs^Fms, Gs^Fms, Gd, Gd, Dd, Ce, Ce, Dd, Gd, Gs, Gs, Gs
Gs^Ft, Gs^Ft, Gs^Ft, Gs^Ft, Dd, Dd, Rd, Co, Rp, Rp, Co, Rp, Rp, Rp, Rp, Rp^Vhc, Rp, Rp, Rp, Rp, Dd, Dd, Dd^Es, Dd, Dd, Gs^Ft, Gs^Ft, Ww, Dd^Ftd, Dd, Dd, Gd^Es, Gd, Dd, Gd, Dd, Dd, Dd^Es, Gd, Gs^Fms, Gs, Gs, Gd, Dd^Es, Dd^Es, Dd, Dd, Ce, Gd, Gg^Vc, Gd, Gg
Gg, Gs^Ft, Gs^Ft, Gs^Ft, Rd, Rd, Dd, Dd, Dd, Rp, Co, Ko, Co, Rp, Rp, Rp, Rp, Rp, Rp, Dd, Dd^Vda, Dd^Vo, Dd, Dd, Gs^Ft, Gs^Ft, Ww, Ww, Dd^Ftd, Dd^Vda, Dd, Hhd, Hhd, Gd, Gd, Dd, Dd^Es, Gd^Es, Gd, Gd, Gd, Gd, Gd^Vht, Gd, Dd^Es, Dd^Es, Dd^Es, Dd, Dd, Gd, Dd, Gd
Gg, Gg, Gg, Gg, Gs, Gd, Dd, Dd^Es, Dd^Vo, Dd, Dd, Co, Rp, Rp, Rp, Rp, Rp, Rp, Rp, Dd, Dd, Dd, Gd, Gs, Gs, Gs^Ft, Ww, Dd^Ftd, Ss, Dd, Dd, Dd^Es, Dd, Dd, Dd^Es, Dd^Es, Dd, Dd, Dd, Dd^Es, Dd^Es, Gd, Gd, Gd, Gd^Es, Dd, Gd^Es, Dd, Dd^Es, Dd, Dd^Es, Dd
Gg, Rd, Gs, Gs, Dd^Es, Gd, Gd, Dd, Dd, Dd, Dd^Es, Dd, Dd, Rp, Co, Rp, Rp, Rp, Co, Dd, Dd^Es, Dd, Gd, Gs, Gs^Ft, Gs^Ft, Ss, Ww, Ww, Ww, Ss, Dd, Dd, Dd^Es, Dd, Dd^Es, Gd, Dd, Gd, Dd, Dd^Es, Gd, Dd^Es, Dd^Es, Dd, Gd, Dd, Dd^Es, Dd, Dd, Dd, Dd^Es
Gg, Gg, Gs, Dd, Dd, Dd^Es, Gd, Gd, Gd, Dd, Dd, Dd, Dd, Dd, Dd, Rp, Rp, Rp, Dd, Dd, Dd^Es, Dd, Gd, Gs, Gs, Ss, Ss, Ww, Ww, Ww, Ww, Dd^Ftd, Ww, Dd, Dd, Gd, Gs, Gs, Gs, Gd, Gd, Gd, Dd, Dd^Es, Dd, Gd, Gd, Dd, Gd, Gd^Es, Gd, Dd
Gs^Fms, Gg, Gg^Vo, Gs, Gs, Gd, Dd, Dd^Es, Gs, Gs, Gs, Gs, Gs, Dd, Dd, Dd, Dd, Dd, Dd^Es, Dd^Es, Dd, Dd, Gd, Gs, Gs, Ss, Gs, Ss, Ss, Ss, Ww, Ww, Ww, Dd, Dd, Gd, Gs, Ss, Ss, Gs, Gs, Gd, Gd, Dd, Gd, Gd, Gs, Gd, Gs^Vht, Gd, Gd, Dd
Gs^Fms, Gs^Fms, Gs^Fms, Gs^Fms, Gg, Dd, Gg, Dd, Gg, Gs, Gs, Re^Gvs, Re^Gvs, Gs, Dd, Dd^Es, Dd, Dd^Es, Dd, Dd, Gd, Gd, Gs, Gs, Gs, Gs, Gs, Ss, Gs, Ss, Ss^Vo, Ww, Wo, Ww, Ww, Ww, Ww, Ss, Ww, Ss, Ww, Gs, Gs, Gs, Gs, Gs, Ss, Gs^Ft, Gs^Ft, Gs, Gd, Dd
Gs^Fms, Gs^Fms, Gs^Fms, Gs^Fms, Gg, Gg, Gs^Fms, Gg, Gs^Fms, Gg, Gs, Gs, Gs, Gs, Gd, Dd, Gd, Dd, Gd, Gd, Gs, Gs, Gs, Gs, Gs, Gs, Gs, Gs, Gs, Ss, Ss, Ww, Wo, Wo, Wo, Ww, Wo, Ww, Wo, Ww, Ww, Ww, Ww, Ww, Ww, Ss, Ss, Gs^Ft, Gs, Gs, Dd, Dd
Gg, Gs^Fms, Gg, Gg, Gg, Gg, Gs^Fms, Gs^Fms, Gs^Fms, Gg, Gs^Vo, Gs, Gs, Gs, Gs, Gd, Gs, Gd, Gs, Gs, Gs, Gs^Vo, Gs, Gs, Gs, Gs, Gs^Ft, Gs^Ft, Ss, Ss, Ss, Ww, Ww, Ww, Ww, Wo, Wo, Wo, Wo, Wo, Wo, Wo, Wo, Ww, Wo, Ww, Ww, Ss, Gs, Gd, Dd^Es, Dd^Es
Gg, Gg, Gg, Gg, Gg, Gg, Gs^Fms, Gs^Fms, Gs^Fms, Gg, Gg, Gs, Gg, Gs, Gs, Gs, Gs, Gs, Gs, Gs, Dd, Gs, Dd^Es, Dd^Es, Gs, Gg, Gg, Gg, Gg, Ss, Ss, Ss, Ss, Ss, Ss, Ww, Ww, Ww, Wo, Wo, Wo, Wo, Wo, Wo, Ww, Ww, Ss, Ss, Gg, Gd, Dd, Dd^Es
