border_size=1
usage=map

Ss, Gs, Gs, Hh, Hh, Hh^Fmw, Hh^Fmw, Hh, Gs, Gs, Gs^Fp, Gg, Hh^Ftp, Hh^Ftp, Gs, Gs, Hh^Ftp, Hh^Ftp, Hh^Ftp, Gs^Fmw, Hh^Ftp, Hh^Ftp, Hh^Ftp, Hh^Ftp, Hh^Ftp, Hh^Ftp, Mm, Hh^Ftp, Mm, Mm^Xm
Ss, Gs, Gs, Gs, Hh^Fmw, Hh, Gs, Hh^Fmw, Gs, Gs, Gs^Fp, Gs^Fp, Gs, Gs, Gs, Gs, Gs, Hh^Ftp, Gs^Fp, Gs, Gs, Gs, Gs, Gs, Hh^Ftp, Hh^Ftp, Hh^Ftp, Mm, Mm, Mm^Xm
Wwg, Ss, Gs, Gs, Gs, Gs, Gg^Vo, Gs, Gg, Gs^Fp, Gs, Gs, Ds, Gs, Ds, Ds, Gs, Gs, Gs^Fp, Gs^Fp, Gg, Gg, Gg^Vo, Gs, Gs, Hh^Ftp, Hh^Ftp, Mm, Mm, Mm^Xm
Wwg, Ss, Ss, Gs, Gs, Gg, Gg, Gg, Gs^Fp, Gg, Gs, Ds, Dd, Ds, Dd^Vdt, Ds, Gs, Gg, Gg, Gg, Gg, Gg, Gs, Gs, Gs, Hh^Ftp, Hh^Ftp, Mm, Mm, Mm^Xm
Ss, Wwg, Ss, Ss, Ce, Ce, Ce, Gg, Gg, Gs^Fp, Gs, Ds, Ds, Ds, Ds, Ds, Ds, Gs, Hh^Fp, Hh^Fp, Gg, Gs, Gs, Gs, Hh^Ftp, Hh^Ftp, Mm, Mm, Mm^Xm, Mm^Xm
Ss, Wwg, Ww, Ss, Ce, 2 Ke, Ce, Gs, Gg, Gs^Fp, Gs, Gs, Ds, Dd^Dr, Ds, Hhd, Hhd, Gs, Gs, Gg, Gs, Gs, Gs, Gs, Hh^Ftp, Hh^Ftp, Mm, Mm^Xm, Mm, Mm
Gs, Ss, Ww, Ss, Ss, Ce, Gs, Gs, Gg, Gg, Gg, Gs, Gs, Ds, Gs, Hhd, Hhd, Hhd, Gs, Gs, Gs, Gs, Gs, Hh^Ftp, Hh^Ftp, Mm, Mm^Xm, Mm^Xm, Mm, Hh^Ftp
Gs, Ss, Ss, Ww, Ss, Ss, Ss, Ss, Gs, Gg^Vo, Gg, Hh^Fp, Hh^Fp, Gs, Hh^Fp, Gs, Gs, Gs, Gs, Gs, Wwf, Gs, Wwf, Hh^Ftp, Hh^Ftp, Mm, Mm^Xm, Mm, Hh^Ftp, Hh^Ftp
Gs, Gs, Ss, Ww, Ww, Ss, Ww, Ss, Ss, Gs, Gs, Hh^Fp, Gs, Gs, Gs, Gs, Ww, Ww, Ww, Ww, Ww, Wwf, Ss, Ss, Mm, Mm, Mm^Xm, Mm, Hh^Ftp, Hh^Ftp
Gs, Gs, Ss, Ss, Ss, Ww, Ss, Ww, Ww, Ss, Ss, Gs, Ss, Ww, Ww, Ww, Hh^Ftp, Ww, Wo, Ww, Wo^Bw|, Wwf, Ss, Hh^Ft, Mm^Xm, Mm^Xm, Mm, Mm, Hh^Ftp, Gs
Gs, Gs, Gs, Ss, Gs, Ss, Ss, Ss, Ww, Ww, Ww, Ss, Ww, Ww, Hh^Ftp, Hh^Ftp, Mm, Mm, Mm, Wo, Wo^Bw|, Wo, Mm, Mm, Mm, Mm, Mm, Hh^Ftp, Hh^Ftp, Gs
Ds, Gs, Ds, Gs, Ds, Gs, Gs, Ss, Ss, Ww, Hh^Ftp, Ww, Hh^Ftp, Hh^Ftp, Mm, Mm, Mm^Xm, Mm^Xm, Mm, Ww, Wo^Bw|, Wo, Wo, Mm, Hh^Ftp, Hh^Ftp, Hh^Ftp, Hh^Ftp, Gs, Gs
Ds, Ds, Dd^Vdt, Ds, Ds, Gs, Hh^Ftp, Gs, Hh^Ftp, Hh^Ftp, Mm, Hh^Ftp, Mm, Mm, Mm^Xm, Mm^Xm, Mm, Mm, Hh^Ftp, Ww, Wo^Bw|, Wwf, Wo, Ww, Ww, Hh^Ftp, Ss, Ss, Gs, Gs^Fp
Ds, Ds, Ds, Ds, Gs, Gs, Hh^Ftp, Hh^Ftp, Mm, Mm, Mm^Xm, Mm, Mm^Xm, Mm^Xm, Mm, Mm, Hh^Ftp, Hh^Ftp, Wwf, Wwf, Wwf, Hh^Ftp, Ww, Wo, Ww, Ss, Gs, Gs, Gs^Fp, Gs^Fp
Ds, Ds, Gs, Gs, Hh^Ftp, Hh^Ftp, Mm, Mm, Mm^Xm, Mm^Xm, Mm, Mm^Xm, Mm, Mm, Hh^Ftp, Hh^Ftp, Hh^Ftp, Hh^Ftp, Hh^Ftp, Gs, Gs, Hh^Ftp, Wwf, Wo, Wo, Wwf, Ss, Gs, Gs^Fp, Hhd^Fdf
Gs, Ds, Gs, Hh^Ftp, Hh^Ftp, Mm, Mm, Mm^Xm, Mm, Mm, Hh^Ftp, Mm, Mm, Hh^Ftp, Hh^Ftp, Hhd, Hhd, Gs, Hh^Ftp, Gs, Gs^Vht, Gs, Ss, Wwf, Ww, Wwf, Ss, Ss^Vhs, Gs^Fp, Hhd^Fdf
Gs, Gs, Hh^Ftp, Hh^Ftp, Mm, Mm, Mm^Xm, Mm^Xm, Mm, Mm, Hh^Ftp, Hh^Ftp, Hh^Ftp, Hh^Ftp, Hhd, Hhd, Gs, Gs, Gs, Gs, Gs, Gs, Ss, Ww, Ww, Ss, Gs^Fp, Gs^Fp, Hhd^Fmf, Hhd^Fdf
Gs, Gs, Hh^Ftp, Mm, Mm^Xm, Mm^Xm, Mm, Mm, Hh^Ftp, Hh^Ftp, Hhd, Hhd, Hhd, Hhd, Gs, Gs, Gs, Gs, Ss, Gs, Ss, Ss, Ww, Ww, Ss, Ss, Gs^Fp, Hhd^Fmf, Hhd^Fmf, Hhd^Fdf
Hh^Ftp, Hh^Ftp, Mm, Mm, Mm^Xm, Mm, Hh^Ftp, Hh^Ftp, Hhd, Hhd, Co, Chr, Chr, Gs, Gs, Gs, Ss, Ss, Ww, Ss, Ww, Ww, Ss, Ss, Gs, Ss, Gs^Fp, Gs^Fp, Hhd^Fmf, Hhd^Fdf
Mm, Mm, Mm^Xm, Mm^Xm, Mm, Mm, Hh^Ftp, Hh^Ftp, Hhd, Hhd, Co, Khr, Chr, Gs, Hh, Gs, Ss, Ww, Wo, Ww, Ss, Ss, Gs, Gs, Gs^Fp, Gs, Gs^Fp, Gs^Fp, Hhd^Fmf, Hh
Mm^Xm, Mm^Xm, Mm^Xm, Mm, Mm, Hh^Ftp, Hh^Ftp, Hhd, Ds, Hhd, Gs, Co, Gs, Gs, Hh, Gs, Ss, Ww, Ww, Ww, Ss, Gs, Gs^Fp, Gs^Fp, Gs^Fp, Gs^Fp, Gg^Ve, Gs^Fp, Hh, Mm
Mm, Mm^Xm, Mm, Mm, Hh^Ftp, Hh^Ftp, Hhd, Hhd, Ds, Gs, Gs^Fp, Gs, Gs, Gs, Gs, Gs, Gs, Ss, Ss, Ss, Gs, Gs, Gs, Gs, Gs^Fp, Gs^Fp, Gs^Fp, Gs^Fp, Hhd^Fdf, Mm
Hh^Ftp, Mm, Hh^Ftp, Hh^Ftp, Hhd, Hhd, Ds, Ds, Ds, Gs, Gs^Fp, Gs, Gs^Fp, Gs, Gs, Gs, Hh, Gs, Gs, Gs, Gs, Gs, Gs, Gs, Gs, Gs, Gg, Gs^Fp, Gs^Fp, Hhd^Fdf
Hhd, Hh^Ftp, Hhd, Hhd, Ds, Ds, Dd^Vdt, Ds, Gs, Gs, Gs^Fp, Gs^Fp, Gs^Fp, Gs^Fp, Gs, Gs, Gs, Gs, Hh, Hh, Gs, Gs, Gs^Fp, Gs, Hh, Gs, Gg, Gs^Fp, Gs^Fp, Hhd^Fdf
Ds, Hhd, Ds, Hhd, Ds, Ds, Ds, Ds, Gs, Gs, Gs^Fp, Gs^Fp, Gs^Fp, Gs, Gs^Fp, Gs, Gs^Fp, Gs, Gs, Gs, Gs^Fp, Gs^Fp, Gs^Fp, Gs, Gs, Hh, 1 Gs, Gs^Fp, Gs^Fp, Gs^Fp
Ds, Ds, Gs, Ds, Gs, Gs, Gs, Gs, Gs^Fp, Gs^Fp, Gs^Fp, Hh^Fp, Hh^Fp, Gs^Fp, Gs^Fp, Gs^Fp, Gs^Fp, Gs^Fp, Gs^Fp, Gs^Fp, Gs^Fp, Hh^Fp, Hh^Fp, Gs^Fp, Gs^Fp, Gs, Gs, Gg, Gs^Fp, Gs^Fp
Gs, Gs, Gs, Gs, Gs^Fp, Gs^Fp, Hh^Fp, Gs, Gs, Gs, Gs^Fp, Gs^Fp, Gs^Fp, Gs^Fp, Gg, Gg^Ve, Hh^Fp, Hh^Fp, Gs^Fp, Gs, Hh^Fp, Hh^Fp, Hh, Gs^Fp, Gs^Fp, Gs, Gs, Hh, Hh^Fp, Hh
Gs, Gll^Fp, Gll^Fp, Gs^Fp, Hh, Hh^Fp, Hh^Fp, Hh, Gs, Gs^Fp, Gs^Fp, Hh, Hh, Hh, Hh, Gs^Fp, Gs^Fp, Gs^Fp, Hh, Hh, Mm, Mm, Mm, Hh, Gs, Gs, Gs, Hh, Hh, Gs