border_size=1
usage=map

Ss, Gs, Gs, Hh, Hh, Hh^Fmw, Hh^Fmw, Hh, Gs^Es, Gs, Gs^Fmf, Gg, Hh^Ftp, Hh^Ftp, Gs^Es, Gs, Hhd^Fdf, Hhd^Fdf, Hhd^Fdf, Hhd^Fdf, Hhd^Fmf, Hhd^Fdf, Hhd^Fmf, Hhd^Fdf, Hhd^Fdf, Hhd^Fdf, Mm, Hh^Ftp, Mm, Mm^Xm
Ss, Gs, Gs, Gs^Es, Hh^Fmw, Hh^Es, Gs^Es, Hh^Fmw, Gs, Gs, Gs^Fmf, Gs^Fmf, Gd, Gs, Gd^Es, Gd^Es, Gd, Hhd^Fdf, Gs^Fmf, Gd, Gs, Gd^Es, Gs, Gd^Es, Hhd^Fmf, Hhd^Fdf, Hhd^Fmf, Mm, Mm, Mm^Xm
Wwg, Ss, Gs, Gs^Es, Gs, Gs, Gs^Vo, Gs, Gs, Gs^Fmf, Gd, Gd, Dd, Gd, Dd, Dd^Es, Gd, Gs, Gs^Fmf, Gs^Fmf, Gs, Gs, Gs^Vo, Gs, Gd^Es, Hhd^Fdf, Hhd^Fmf, Mm, Mm, Mm^Xm
Wwg, Ss, Ss, Gs, Gs, Gs, Gs, Gs, Gs^Fmf, Gs, Gd, Dd, Dd^Es, Dd, Dd^Vdt, Dd, Gd^Es, Gs, Gs, Gs, Gs, Gs, Gs, Gs, Gd^Es, Hhd^Fdf, Hhd^Fmf, Mm, Mm, Mm^Xm
Ss, Wwg, Ss, Ss, Ce, Ce, Ce, Gs, Gs, Gs^Fmf, Gd, Dd, Dd, Dd^Es, Dd, Dd, Dd^Es, Gs, Hh^Fmf, Hh^Fmf, Gs, Gs, Gs^Es, Gs, Hhd^Fmf, Hhd^Fdf, Mm, Mm, Mm^Xm, Mm^Xm
Ss, Wwg, Ww, Ss, Ce, 2 Ke, Ce, Gs, Gs, Gs^Fmf, Gs, Gd^Es, Dd, Dd^Dr, Dd, Hd, Hh^Es, Gs, Gs, Gs, Gs, Gs^Es, Gd^Es, Gd^Es, Hhd^Fmf, Hhd^Fdf, Mm, Mm^Xm, Mm, Mm
Gs, Ss, Ww, Ss, Ss, Ce, Gs, Gs, Gs, Gs, Gs, Gd, Gd, Dd, Gd, Hh, Hh^Es, Hh^Es, Gs^Es, Gs^Es, Gs, Gs, Gd, Hhd^Fmf, Hhd^Fmf, Mm, Mm^Xm, Mm^Xm, Mm, Hhd^Fdf
Gs, Ss, Ss, Ww, Ss, Ss, Ss, Ss, Gs, Gs^Vo, Gs, Hh^Fmf, Hh^Fmf, Gd, Hh^Fmf, Gs, Gs, Gs, Gs, Gs, Wwf, Gs, Wwf, Hhd^Fdf, Hhd^Fmf, Mm, Mm^Xm, Mm, Hhd^Fmf, Hhd^Fdf
Gs, Gs, Ss, Ww, Ww, Ss, Ww, Ss, Ss, Gs, Gs, Hh^Fmf, Gs, Gs, Gs, Gs, Ww, Ww, Ww, Ww, Ww, Wwf, Ss, Ss, Mm, Mm, Mm^Xm, Mm, Hhd^Fmf, Hhd^Fdf
Gs, Gs, Ss, Ss, Ss, Ww, Ss, Ww, Ww, Ss, Ss, Gs, Ss, Ww, Ww, Ww, Hhd^Fmf, Ww, Wo, Ww, Wo^Bw|, Wwf, Ss, Hhd^Fmf, Mm^Xm, Mm^Xm, Mm, Mm, Hhd^Fmf, Gs^Es
Gd, Gs, Gd, Ss, Gd, Ss, Ss, Ss, Ww, Ww, Ww, Ss, Ww, Ww, Hhd^Fmf, Hhd^Fmf, Mm, Mm, Mm, Wo, Wo^Bw|, Wo, Mm, Mm, Mm, Mm, Mm, Hhd^Fdf, Hhd^Fmf, Gs^Es
Dd, Gd, Dd, Gd, Dd^Es, Gd, Gs, Ss, Ss, Ww, Hhd^Fmf, Ww, Hhd^Fmf, Hhd^Fmf, Mm, Mm, Mm^Xm, Mm^Xm, Mm, Ww, Wo^Bw|, Wo, Wo, Mm, Hhd^Fmf, Hhd^Fdf, Hhd^Fmf, Hhd^Fmf, Gs, Gs
Dd, Dd, Dd^Vdt, Dd, Dd^Es, Gd, Hhd^Fmf, Gs, Hhd^Fmf, Hhd^Fmf, Mm, Hhd^Fmf, Mm, Mm, Mm^Xm, Mm^Xm, Mm, Mm, Hhd^Fmf, Ww, Wo^Bw|, Wwf, Wo, Ww, Ww, Hhd^Fmf, Ss, Ss, Gs, Gs^Fp
Dd, Dd, Dd, Dd, Gd^Es, Gd^Es, Hhd^Fmf, Hhd^Fmf, Mm, Mm, Mm^Xm, Mm, Mm^Xm, Mm^Xm, Mm, Mm, Hhd^Fdf, Hhd^Fmf, Wwf, Wwf, Wwf, Hhd^Fmf, Ww, Wo, Ww, Ss, Gs, Gs, Gll^Fmf, Gll^Fmf
Dd, Dd, Gd^Es, Gd^Es, Hhd^Fmf, Hhd^Fmf, Mm, Mm, Mm^Xm, Mm^Xm, Mm, Mm^Xm, Mm, Mm, Hhd^Fdf, Hhd^Fdf, Hhd^Fmf, Hhd^Fmf, Hhd^Fmf, Gs, Gs, Hhd^Fmf, Wwf, Wo, Wo, Wwf, Ss, Gs, Gll^Fmf, Hhd^Fdf
Gd, Dd^Es, Gd^Es, Hhd^Fmf, Hhd^Fmf, Mm, Mm, Mm^Xm, Mm, Mm, Hhd^Fmf, Mm, Mm, Hhd^Fmf, Hhd^Fdf, Hhd^Es, Hhd, Gd^Es, Hhd^Fmf, Gs^Es, Gs^Vht, Gs, Ss, Wwf, Ww, Wwf, Ss, Ss^Vhs, Gll^Fmf, Hhd^Fdf
Gd^Es, Gd^Es, Hhd^Fmf, Hhd^Fmf, Mm, Mm, Mm^Xm, Mm^Xm, Mm, Mm, Hhd^Fmf, Hhd^Fdf, Hhd^Fdf, Hhd^Fmf, Hhd, Hhd^Es, Gs^Es, Gs, Gs, Gs, Gs, Gs, Ss, Ww, Ww, Ss, Gll^Fmf, Gll^Fmf, Hhd^Fmf, Hhd^Fdf
Gd^Es, Gd^Es, Hhd^Fmf, Mm, Mm^Xm, Mm^Xm, Mm, Mm, Hhd^Fdf, Hhd^Fmf, Hhd^Es, Hhd^Es, Hhd^Es, Hhd^Es, Gd, Gs^Es, Gs, Gs, Ss, Gs, Ss, Ss, Ww, Ww, Ss, Ss, Gll^Fmf, Hhd^Fmf, Hhd^Fmf, Hhd^Fdf
Hhd^Fmf, Hhd^Fmf, Mm, Mm, Mm^Xm, Mm, Hhd^Fmf, Hhd^Fmf, Hhd^Es, Hhd^Es, Co, Chr, Chr, Gd^Es, Gs, Gs, Ss, Ss, Ww, Ss, Ww, Ww, Ss, Ss, Gs, Ss, Gll^Fmf, Gll^Fmf, Hhd^Fmf, Hhd^Fdf
Mm, Mm, Mm^Xm, Mm^Xm, Mm, Mm, Hhd^Fdf, Hhd^Fmf, Hhd^Es, Hhd^Es, Co, Khr, Chr, Gs, Hh, Gs, Ss, Ww, Wo, Ww, Ss, Ss, Gs, Gs, Gs^Fp, Gs, Gll^Fmf, Gll^Fmf, Hhd^Fmf, Hh
Mm^Xm, Mm^Xm, Mm^Xm, Mm, Mm, Hhd^Fdf, Hhd^Fdf, Hhd, Dd^Es, Hhd^Es, Gd, Co, Gs, Gs, Hh^Es, Gs, Ss, Ww, Ww, Ww, Ss, Gs, Gs^Fp, Gs^Fp, Gll^Fmf, Gs^Fp, Gg^Ve, Gll^Fmf, Hh, Mm
Mm, Mm^Xm, Mm, Mm, Hhd^Fmf, Hhd^Fmf, Hhd^Fmf, Hhd^Fdf, Dd, Gd, Gs^Fp, Gs, Gs, Gs^Es, Gs, Gs, Gs, Ss, Ss, Ss, Gs, Gs, Gs, Gs, Gs^Fp, Gll^Fmf, Gll^Fmf, Gll^Fmf, Hhd^Fdf, Mm
Hhd^Fmf, Mm, Hhd^Fmf, Hhd^Fdf, Hhd^Es, Hhd^Es, Dd^Es, Dd^Es, Dd^Es, Gd, Gs^Fp, Gs, Gs^Fp, Gs, Gs, Gs, Hh, Gs, Gs, Gs, Gs, Gs^Es, Gs, Gs, Gs, Gs, Gs, Gll^Fmf, Gll^Fmf, Hhd^Fdf
Hhd, Hhd^Fmf, Hhd, Hhd^Es, Dd^Es, Dd^Es, Dd^Vdt, Dd, Gd, Gd, Gs^Fp, Gs^Fp, Gs^Fp, Gs^Fp, Gs, Gs, Gs, Gs, Hh^Es, Hh, Gs, Gs, Gs^Fp, Gs, Hh^Es, Gs, Gs, Gll^Fmf, Gll^Fmf, Hhd^Fdf
Dd, Hhd^Es, Dd^Es, Hhd^Es, Dd, Dd, Dd, Dd, Gd, Gs, Gs^Fp, Gs^Fmf, Gs^Fp, Gs, Gs^Fp, Gs, Gs^Fp, Gs, Gs, Gs, Gs^Fp, Gs^Fp, Gs^Fp, Gs, Gs, Hh^Es, 1 Gs, Gll^Fmf, Gll^Fmf, Gll^Fmf
Dd, Dd, Gd, Dd, Gd, Gd, Gd, Gd, Gs^Fp, Gs^Fp, Gs^Fp, Hh^Fmf, Hh^Fmf, Gs^Fp, Gs^Fp, Gs^Fp, Gs^Fp, Gs^Fp, Gs^Fp, Gs^Fp, Gs^Fp, Hh^Fp, Hh^Fp, Gs^Fp, Gs^Fp, Gs, Gs, Gs, Gll^Fmf, Gll^Fmf
Gd, Gd, Gd, Gd, Gs^Fp, Gs^Fp, Hh^Fmf, Gs, Gs, Gs, Gs^Fp, Gs^Fmf, Gs^Fmf, Gs^Fp, Gg, Gg^Ve, Hh^Fmf, Hh^Fmf, Gs^Fp, Gs, Hh^Fp, Hh^Fp, Hh, Gs^Fp, Gs^Fp, Gs, Gs, Hh^Es, Gll^Fmf, Hh
Gs, Gll^Fp, Gll^Fp, Gs^Fp, Hh^Fmf, Hh^Fmf, Hh^Fmf, Hh, Gs, Gs^Fp, Gs^Fp, Hh, Hh, Hh, Hh, Gs^Fmf, Gs^Fp, Gs^Fp, Hh, Hh, Mm, Mm, Mm, Hh, Gs, Gs, Gs, Hh, Hh, Gs
