border_size=1
usage=map

Ss          , Ss          , Ss          , Ss          , Gg          , Gg          , Re          , Re          , Gg          , Gs^Fmf      , Gs^Fmf      , Gs          , Gs          , Ss          , Ss          , Ss          , Ss          , Ww          , Ww          , Ww          , Ss          , Ss          , Ss          , Ss          , Ss          , Ss          , Ss          , Ss          , Ss          , Ss          , Ss          , Ss          , Ss          , Ss          , Ss          , Ss          
Ss          , Ss          , Gg          , Gg          , Re          , Re          , Gg          , Gg          , Ss          , Gs          , Gs          , Gs          , Gg          , Ss          , Gs          , Ss          , Gs          , Ss          , Ww          , Ww          , Ww          , Ss          , Ss          , Ss          , Ss^Vm       , Ss          , Ss          , Ss          , Ss          , Ss          , Ss          , Ss          , Chs         , Ss          , Ss          , Ss          
Ss          , Ss          , Gg          , Re          , Gg          , Gg          , Ce          , Gg          , Gg          , Ss          , Gg          , Gg^Vo       , Gg          , Gg          , Gs^Fdf      , Gs          , Gs          , Ss          , Ss          , Ww          , Wwf         , Ss          , Ss          , Ss          , Ss          , Ss          , Ss          , Ss          , Ss          , Ss          , Ss          , Chs         , 2 Khs       , Chs         , Ss          , Ss          
Gg          , Gg          , Gg          , Re          , Gg          , Ce          , 3 Ke        , Ce          , Gs          , Gg          , Gg          , Gg          , Gg          , Gg          , Gs^Fmf      , Gs^Fmf      , Gs          , Gs          , Ss          , Wwf         , Wwf         , Ss          , Ss          , Ss          , Ss          , Ss          , Ss          , Ss          , Ss          , Ss          , Ss          , Chs         , Chs         , Chs         , Ss          , Ss          
Gg          , Gg^Vo       , Gg          , Re          , Gg          , Ce          , Ce          , Ce          , Gs          , Gs^Fmf      , Gs^Fmf      , Gs^Fmf      , Gs^Fmf      , Gg          , Gg          , Gs          , Gs          , Ss          , Ss          , Ss          , Ww          , Ww          , Ss          , Ss          , Ss          , Gs          , Gs          , Gs          , Gs          , Ss          , Ss          , Ss          , Ss          , Ss          , Ss          , Gg          
Gs          , Gg          , Gg          , Re          , Gg          , Gs          , Gs          , Gs          , Ss          , Gs          , Gs^Fmf      , Gs^Fdf      , Gs^Fmf      , Gs          , Ss          , Gs          , Ss          , Gs          , Gs          , Ss          , Ss          , Ww          , Wwf         , Ss          , Ss          , Gs          , Ss          , Gs          , Gs          , Ss          , Ss          , Ss          , Ss          , Ss^Vhs      , Ss          , Ss          
Gs          , Gs          , Gg          , Re          , Gg          , Gs          , Gs          , Ss          , Gs          , Gs          , Gs          , Gs          , Gs          , Gs          , Gs          , Ss          , Ss          , Gs          , Ss          , Ss          , Ss          , Wwf         , Wwf         , Ss          , Ss          , Ss          , Ss          , Ss          , Ss          , Ss          , Ss          , Ss          , Ss          , Ss          , Ss          , Ss          
Gs          , Gs          , Gg          , Re          , Gg          , Gg^Vo       , Gg          , Gs          , Gs^Fmf      , Gs          , Gs^Fmf      , Gs          , Ss          , Gs          , Ss          , Gs          , Ss          , Ss          , Ss          , Ss          , Gs          , Ss          , Wwf         , Ww          , Ss          , Ss          , Ss          , Ss          , Ss^Vhs      , Ss          , Ss          , Ss          , Ss          , Gs          , Gs          , Gs          
Ss          , Ss          , Gg          , Re          , Gg          , Gg          , Gg          , Gs^Fmf      , Gs^Fmf      , Gs^Fmf      , Gs^Fmf      , Gs          , Gs          , Ss          , Ss          , Gs          , Ss          , Ss^Vm       , Ss          , Gs          , Gs          , Ss          , Ss          , Ww          , Ww          , Ss          , Ss          , Ss          , Ss          , Ss          , Ss          , Ss          , Gs          , Gs          , Gs^Fmf      , Gs^Fmf      
Ww          , Ww          , Ww          , Re          , Ww          , Gg          , Gs          , Gs          , Gs          , Gs^Fmf      , Gs          , Gs          , Ss          , Gs          , Ss          , Ss          , Ss          , Ss          , Ss          , Ss          , Ss          , Ss          , Ss          , Ww          , Ww          , Ss          , Ss          , Ss          , Ss          , Ss          , Ss          , Ss          , Gs^Fmf      , Gs^Fmf      , Gs^Fmf      , Gs^Fmf      
Ss          , Ss          , Gs          , Ww^Bw|      , Gs          , Wwf         , Wwf         , Wwf         , Wwf         , Gs          , Ww          , Ss          , Ww          , Ss          , Ww          , Ss          , Ss          , Ss          , Ss          , Ss          , Ww          , Ww          , Ww          , Ww          , Ss          , Ww          , Ww          , Ss          , Ss          , Ss          , Ss          , Ss          , Ss          , Gs          , Ss          , Gs          
Gs          , Gs          , Gs          , Re          , Gs          , Gs          , Gs          , Gs          , Ss          , Ww          , Ss          , Ww          , Ww          , Ww          , Ww          , Ww          , Ww          , Ww          , Ww          , Ss          , Ww          , Ww          , Ww          , Ss          , Ss          , Ww          , Ww          , Ss          , Ss          , Ss          , Ss          , Ss          , Ss          , Ss          , Ss          , Ss          
Gs          , Gs          , Gs          , Re          , Gs          , Ss          , Gs          , Ss^Vhs      , Gs          , Ss          , Ss          , Ss          , Ss          , Ss          , Ss          , Ss          , Ss          , Ww          , Ss          , Ww          , Ss          , Ss          , Ss          , Ss          , Ss          , Ww          , Ss          , Ww          , Ww          , Ww          , Ww          , Ss          , Ww          , Ss          , Ss          , Ss          
Gs          , Gs          , Gs          , Re          , Gs          , Gs          , Gs          , Gs          , Gs          , Ss          , Ss          , Ss          , Ss          , Ss          , Ss          , Ss          , Ss          , Ss          , Ss          , Ss          , Ss          , Ss^Vm       , Ss          , Ss          , Ss          , Ss          , Ss          , Ww          , Ww          , Ww          , Ww          , Ww          , Ww          , Ww          , Ss          , Ss          
Gs          , Gs          , Re          , Re          , Gs          , Gs          , Ce          , Ce          , Ce          , Gs          , Gs          , Ss          , Gs          , Ss          , Gs          , Ss          , Gs          , Ss          , Gs          , Ss          , Ss          , Ss          , Ss          , Ss          , Ss          , Ss          , Ss          , Ss          , Ss          , Ss          , Ss          , Ss          , Ww          , Ww          , Ww          , Ww          
Re          , Re          , Gs          , Gs          , Ss          , Gs          , Ce          , 4 Ke        , Ce          , Gs          , Gg          , Ss          , Gg          , Gs          , Gg^Vo       , Gs          , Gs          , Gs          , Gs          , Ss          , Gs          , Ss          , Gs          , Ss          , Ss          , Ss          , Ss          , Ss^Vm       , Ss          , Ss          , Ss          , Ss          , Ss          , Ww          , Ww          , Ww          
Gg          , Gg          , Gg          , Ss          , Ss          , Gs          , Gs          , Ce          , Gs          , Gs          , Gg          , Gg          , Gg          , Gg          , Gg          , Gg          , Gg          , Gs^Fmf      , Gs^Fmf      , Gs          , Gs          , Gs          , Gs          , Gs          , Gs          , Gs          , Gs          , Ss          , Ss          , Ss          , Ce          , Ce          , Ce          , Ss          , Gs          , Ss          
Gg          , Gg          , Gs^Fmf      , Gg          , Gg          , Gs          , Gs          , Gs          , Gs          , Gg          , Gs^Fmf      , Gg          , Gs^Fp       , Gs^Fmf      , Gs^Fmf      , Gs^Fmf      , Hh^Fp       , Hh^Fp       , Gs^Fmf      , Gs          , Gs^Fmf      , Gs          , Gs          , Gs          , Gs          , Gs          , Gs          , Ss          , Gs          , Ss          , Ce          , 1 Ke        , Ce          , Gg          , Gg          , Gg          
Gs^Fmf      , Gs^Fmf      , Gs^Fp       , Gg^Vo       , Gs^Fmf      , Gg          , Gg          , Gs^Fmf      , Gs^Fmf      , Gs^Fmf      , Hh^Fmw      , Gs^Fmf      , Gs^Fmf      , Gs^Fmf      , Gs^Fp       , Hh^Fp       , Gs^Fmf      , Gs^Fmf      , Hh          , Gs^Fmf      , Hh          , Gs^Fmf      , Hh          , Gs          , Gs^Fmf      , Gs          , Gs          , Gs          , Gs          , Ss          , Ss          , Ce          , Ss          , Gg          , Ss          , Gg          
Gs^Fmf      , Gs^Fmf      , Gs^Fmf      , Gs^Fmf      , Gg          , Gg          , Gg          , Gg          , Gg          , Gs^Fp       , Gs^Fp       , Gs^Fp       , Gs^Fmf      , Gg          , Gg          , Hh^Fp       , Gs^Fmf      , Hh          , Mm          , Hh          , Mm          , Hh          , Mm          , Hh^Vd       , Hh          , Gs^Fmf      , Gs          , Gs          , Gs          , Gs          , Gs          , Ss          , Gs          , Ss          , Ss          , Gg          
Gg          , Gs^Fmf      , Gg          , Gg          , Ds          , Gg          , Ds          , Gg          , Gg          , Gg          , Gg          , Gg^Vo       , Gg          , Gg          , Gg          , Gs^Fmf      , Hh          , Hh          , Mm          , Mm          , Hh          , Hh          , Hh          , Mm          , Hh          , Gs^Fmf      , Gs          , Gs          , Ss          , Gs          , Ss          , Gs          , Gs          , Gg          , Gg          , Ss          
Gg          , Gg          , Ds          , Ds          , Ds          , Ds          , Ds          , Ds          , Ds          , Gg          , Gg          , Gg          , Gg          , Gg          , Gg          , Gg          , Hh          , Mm          , Mm          , Hh          , Gg^Efm      , Gg^Efm      , Hh          , Mm          , Hh          , Hh          , Gs          , Gs          , Gs          , Ss          , Gg          , Ss          , Gg          , Ss          , Gg          , Gg          
