border_size=1
usage=map

Ha^Fpa, Ha^Fpa, Ha^Fpa, Ha^Fpa, Ha^Fpa, Ms, Ms, Ms, Ms, Ms, Ms, Ms, Ms, Ms, Ms^Xm, Mm^Xm, Ms, Ha^Fpa, Ai, Ha^Fpa, Ms, Ha^Fpa, Ha^Fpa, Ms, Ms^Xm, Ms, Hhd^Fmw, Gd, Gd, Gd, Gd, Gd, Hhd, Gd, Gd, Gd, Gd
Ha^Fpa, Ai, Ai, Ai, Ha^Fma, Ms, Ha^Fma, Ha, Ms, Ha^Fma, Ha^Fma, Ha^Fma, Ms, Ms, Ms, Ms, Ms, Ha^Fpa, Ai, Ha^Fpa, Mm, Ha^Fpa, Ha^Fpa, Ha^Fpa, Ha^Fpa, Ms, Hh^Fmw, Hhd^Fmw, Hhd^Fmw, Gd, Gd, Hhd, Hhd, Gd, Gd, 1 Gd, Gd
Ha^Fpa, Ai, Ha, Aa^Fpa, Ms, Ha^Fpa, Cea, Cea, Cea, Ha^Fma, Aa^Fpa, Ha^Fma, Ha^Vdyb, Ha^Fma, Ha, Ai, Ai, Ai, Ms, Ms, Mm, Mm, Mm, Ha^Fpa, Ms, Ms, Hh, Hh^Vd, Hhd^Fmw, Hhd^Fmw, Gd, Gd, Gd, Gd, Gd, Gd, Gd
Aa, Ai, Ha, Gs^Fp, Ha^Fpa, Ms, Cea, 2 Kea, Cea, Aa, Aa^Fpa, Ha^Fpa, Ha, Ha, Ai, Ai, Ha^Fpa, Ha^Fpa, Ha^Fma, Ms, Ha^Fma, Mm, Ms, Ms^Xm, Ms, Hh, Hhd^Fmw, Hhd^Fmw, Gd, Gd, Gd, Gd, Gd, Gd, Aa, Gd, Gd
Re, Ha, Aa, Ha, Hh^Fp, Ms, Ms, Cea, Ha^Fpa, Gs, Gs, Aa^Fpa, Aa^Fpa, Ai, Ha^Fpa, Ha^Fpa, Ha^Fma, Ha^Fma, Mm, Ha^Fma, Hh^Fmw, Hh^Fmw, Ha^Fma, Ms, Ha, Hh, Hhd^Fmw, Gd, Gd, Gd, Gd, Gd, Gd, Gd, Aa, Aa, Gd
Ha^Fpa, Re, Ha^Fpa, Aa, Ha, Ha, Hh^Fp, Hh^Fp, Gs, Gs, Aa^Fpa, Aa^Fpa, Ai, Ai, Hh, Ha^Fma, Aa, Ha^Fma, Mm, Hh^Fdw, Mm, Mm, Ha^Fpa, Ha, Ha^Fpa, Hhd^Fdw, Hhd^Fmw, Hhd^Fmw, Gd, Gd, Gd, Gd, Gd, Aa, Aa, Aa, Gd
Ms, Ha^Fpa, Ha^Vdy, Aa, Re, Ha, Re, Hh^Fp, Ha, Gs, Ai, Ai, Mm, Mm, Ha^Vdye, Ha, Ai, Ai, Hh, Hh^Fmw, Mm, Ha^Fpa, Ha^Fpa, Ha^Fpa, Ha^Vdyc, Ha^Fpa, Ha^Fpa, Hhd, Gd, Gd, Gd, Gd, Gd, Aa, Gd, Gd, Hhd
Ms, Ms, Ha^Fpa, Aa, Aa, Re, Ha, Re, Re, Ha, Ai, Ha^Fpa, Ha^Fma, Mm, Hh, Ha, Ai, Aa, Aa, Hh, Mm, Mm, Ss, Ss, Ha^Fpa, Ha^Fpa, Ha^Fpa, Hhd, Gd, Gd, Gd, Gd, Hhd, Gd, Gd, Hhd, Hhd
Ms, Ms, Ha^Fpa, Ha^Fpa, Ha^Fpa, Aa^Fma, Ai, Ms, Aa^Fpa, Aa, Ha, Ai, Ai, Ha^Fma, Ha^Fpa, Ai, Aa, Aa, Ha, Ha, Mm, Hh^Fmw, Hh, Gs, Gs, Gs, Gs, Gd, Gs, Gd, Gd, Hhd^Fdw, Hhd^Fdw, Hhd, Gd, Gd, Gd
Ms, Ms, Ms, Ha^Fpa, Aa^Fma, Ha, Ms, Ms, Aa^Fpa, Aa, Ha, Ha, Aa^Fda, Ai, Ai, Ai, Hh, Hh, Hh, Ai, Ai, Ss, Gs, Gs, Gs^Fp, Gs, Aa, Gs, Ha^Fpa, Gs, Gd, Gd, Gd, Gd, Gd, Gd, Gd
Ms, Ms, Ms^Xm, Ms, Ms, Ms, Ms, Ha^Fpa, Hh, Gs, Gs, Gs, Aa^Fda, Ha^Fma, Ai, Ha^Fma, Ai, Hh, Ww, Hh, Ss, Ss, Ss, Gs^Fp, Gs^Fmf, Aa, Ha^Fpa, Aa, Ha^Fpa, Gs, Gs, Gd, Gd^Vhs, Gd, Hhd, Hhd, Hhd
Ms, Ms, Ms^Xm, Ms^Xm, Mm^Xm, Ms, Mm, Hh, Hh^Vhhr, Gs, Gs^Fmw, Gs, Gs, Ha^Fma, Ha^Fma, Ai, Mm, Ww, Hh, Ww, Ww, Ss, Ww, Gs^Fp, Ww, Gs^Fp, Ss, Ha^Fpa, Ss, Gs, Ss, Gs, Gs, Gd, Gd, Hhd, Hhd
Ms, Ms, Mm, Mm, Mm, Mm^Xm, Mm, Hh, Gs, Gs, Gs^Fmw, Gs^Fmw, Gs, Gs, Hh^Fdw, Mm, Mm^Vhh, Mm, Mm, Hh, Hh, Ww, Gs, Ww, Ss, Ww, Ww, Ss, Ss, Ss, Ss, Ss, Hh^Fp, Hh^Fp, Hh^Fp, Hhd^Fdw, Hhd
Ms, Ms, Mm, Mm, Ha, Mm, Hh, Hh, Gs, Gs, Gs, Gs, Gs, Gs, Hh^Fdw, Mm, Mm, Mm, Hh, Hh, Gs, Gs, Gs, Ss^Vhs, Ss, Ss, Ss, Ss, Gs, Ss, Ss, Ss, Hh^Fp, Mm, Mm, Hh^Fp, Hhd
Ms, Ha, Ha, Ha, Ai, Ha, Ds, Ds, Gs, Ss, Gs, Hh, Gs, Hh, Hh, Hh, Hh, Hh, Gs, Gs, Gs^Fmw, Gs, Gs, Gs, Gs, Gs, Ss, Gs, Gs^Fp, Gg, Gd, Ss, Ss, Mm, Hh^Fp, Hh^Fp, Gd
Ms, Ha, Mm, Ai, Ww, Ww, Hh^Fmw, Gs, Gs, Ss, Gs, Hh, Gs, Hh, Hh, Gs, Gs, Gs, Gs, Gs, Gs^Fp, Gs^Fp, Gs, Gs, Ss, Ss^Bw\, Gs, Gs, Gs, Gg, Ss, Ss, Ss, Hh^Fp, Ss, Gs, Gs
Ms, Mm, Mm, Ai, Ss, Ww, Co, Gs, Gs, Ss, Ss, Gs, Gs, Gs, Hh^Fp, Gs, Gs, Gs, Gs, Gs, Gs, Gs, Ss, Gs, Ss, Ss, Gs, Gs, Co, Co, Co, Ss, Ss, Gs, Ss, Ss, Ss
Ms, Mm, Mm, Mm, Ss, Co, 3 Ke, Co, Ss, Ss, Ss, Gs, Gs, Gg, Gs, Hh^Fp, Gs, Ss, Ss, Ss, Ss, Ss, Ss, Ss, Ss, Gs, Gs, Gs, Co, 4 Ke, Co, Ss, Ss, Ss, Ww, Ww, Ss
Ms, Mm, Mm, Mm, Gs, Co, Co, Co, Ss, Ss, Gs, Gs, Gs, Gs, Ss, Gs, Ss, Ss, Ss, Ss, Ss, Ss, Ww, Ww, Ss, Ss, Ss, Ss, Gs, Co, Gd, Gd, Ss, Ss, Ss, Ww, Ss
Ha^Fpa, Mm, Hh^Vhhr, Hh, Hh^Fdw, Hh, Gs, Gs, Ss, Ss, Ss, Ss, Ss, Ss, Ss, Ss, Ss, Ss^Vm, Ss, Ss, Hh^Fms, Ss, Ss, Ss, Ss, Ss, Ss, Gs, Gg, Gd, Gd, Ss, Gd, Gd^Vhs, Ss, Ss, Ss
Ha^Fpa, Ha^Fpa, Ha^Fpa, Hh^Fdw, Hh^Fmw, Gs, Ss, Ss, Ss, Ss^Vhs, Ss, Ss, Ss, Ss, Ss, Ss, Ss, Ss, Ss, Ss, Hh^Fms, Hh^Fms, Ss, Ss, Gs, Ss, Gs, Gg, Gd, Gd, Gd, Gd, Gd, Gd, Ss, Ss, Ss
Aa, Aa, Aa, Hh^Fmw, Gs, Gs, Gs, Gs, Gs, Gs, Ss, Ss, Ss, Ss, Ss, Ss, Ss, Ss, Ss, Hh^Fms, Hh^Fms, Hh^Fms, Ss, Ss, Gs, Gs, Gs, Gd, Gd, Gd, Gd, Ss, Ss, Ss, Ss, Ss, Ss