border_size=1
usage=map

Ha^Fpa, Ha^Fpa, Ha^Fpa, Ha^Fpa, Ha^Fpa, Ms, Ms, Ms, Ms, Ms, Ms, Ms, Ms, Ms, Ms^Xm, Mm^Xm, Ha^Fpa, Ha^Fpa, Ai, Ha^Fpa, Ms, Ha^Fpa, Ha^Fpa, Ms, Ms^Xm, Ms, Hhd^Fmw, Gd, Gd, Aa, Gd, Gd, Hhd, Gd, Gd, Gd, Gd
Ha^Fpa, Ai, Ai, Ai, Ha^Fma, Ms, Ha^Fma, Ms, Ms, Ha^Fma, Ha^Fma, Ha^Fma, Ms, Ms, Ms, Ha^Fpa, Ai, Ha^Fpa, Ai, Ha^Fpa, Mm, Ha^Fpa, Ha^Fpa, Ha^Fpa, Ha^Fpa, Ms, Hh^Fmw, Hhd^Fmw, Hhd^Fmw, Gd, Gd, Hhd, Hhd, Gd, Gd, 1 Gd, Gd
Ha^Fpa, Ai, Ha, Aa^Fpa, Ms, Ha^Vdye, Ms, Ha^Fpa, Ms, Ms, Cea, Cea, Cea, Ha^Fma, Ha^Vdyb, Ha^Fpa, Ai, Ai, Ms, Ms, Mm, Mm, Mm, Ha^Fpa, Ms, Ms, Hh, Hh^Vd, Hhd^Fmw, Hhd^Fmw, Gd, Gd, Gd, Gd, Gd, Gd, Gd
Aa, Ai, Ha, Gs^Fp, Ha^Fpa, Ms, Ms, Ha^Fpa, Ms, Ms, Cea, 2 Kea, Cea, Ha^Fpa, Ha^Fpa, Ha^Fpa, Ai, Ha^Fpa, Ha^Fma, Ms, Ha^Fma, Mm, Ms, Ms^Xm, Ms, Hh, Hhd^Fmw, Hhd^Fmw, Gd, Gd, Gd, Gd, Gd, Gd, Aa, Gd, Gd
Re, Ha, Aa, Ha, Hh^Fp, Ms, Ms, Ha^Fpa, Ha^Fpa, Ha^Fpa, Aa, Cea, Aa^Fpa, Aa, Ha^Fpa, Ai, Ai, Ha^Fma, Mm, Ha^Fma, Hh^Fmw, Hh^Fmw, Ha^Fma, Ms, Ha, Hh, Hhd^Fmw, Gd, Gd, Hhd^Fdw, Gd, Gd, Gd, Gd, Aa, Aa, Gd
Ha^Fpa, Re, Ha^Fpa, Aa, Ha, Ms, Hh^Fp, Hh^Fp, Gs, Aa, Aa^Fpa, Aa^Fpa, Ai, Ai, Hh, Ha^Fma, Ai, Ha^Fma, Mm, Hh^Fdw, Mm, Mm, Ha^Fpa, Ha, Ha^Fpa, Hhd^Fdw, Hhd^Fmw, Hhd^Fmw, Gd, Gd, Gd, Gd, Gd, Aa, Aa, Aa, Gd
Ms, Ha^Fpa, Ha^Fpa, Aa, Re, Ha, Re, Hh^Fp, Ha, Gs, Ai, Ai, Mm, Mm, Ms, Ha, Ai, Ai, Hh, Hh^Fmw, Mm, Ha^Fpa, Ha^Fpa, Ha^Fpa, Ha^Vdyd, Ha^Fpa, Ha^Fpa, Hhd, Gd, Gd, Gd, Gd, Gd, Aa, Gd, Gd, Hhd
Ms, Ms, Ha^Fpa, Aa, Aa, Re, Ha, Re, Re, Ha, Ai, Ha^Fpa, Ha^Fma, Mm, Hh, Ha, Ai, Aa, Aa, Hh, Mm, Mm, Ss, Ss, Ha^Fpa, Ha^Fpa, Ha^Fpa, Hhd, Gd, Gd, Gd, Gd, Hhd, Gd, Gd, Hhd, Hhd
Ms, Ms, Ha^Vdyc, Ha^Fpa, Ha^Fpa, Aa^Fma, Ai, Ms, Aa^Fpa, Aa, Ha, Ai, Ai, Ha^Fma, Ha^Fpa, Ai, Aa, Aa, Ha, Ha, Mm, Hh^Fmw, Hh, Gs, Gs, Gs, Gs, Gd, Gs, Gd, Gd, Hhd^Fdw, Hhd^Fdw, Hhd, Gd, Gd, Gd
Ms, Ms, Ms, Ha^Fpa, Aa^Fma, Ha, Ms, Ms, Aa^Fpa, Aa, Ha, Ha, Aa^Fda, Ai, Ai, Ai, Hh, Hh, Hh, Ai, Ai, Ss, Gs, Gs, Gs^Fp, Gs, Aa, Gs, Ha^Fpa, Gs, Gd, Gd, Gd, Gd, Gd, Gd, Gd
Ms, Ms, Ms^Xm, Ms, Ms, Ms, Ms, Ha^Fpa, Hh, Aa, Aa, Aa, Aa^Fda, Ha^Fma, Ai, Ha^Fma, Ai, Hh, Ww, Hh, Ss, Ss, Ss, Gs^Fp, Gs^Fmf, Aa, Ha^Fpa, Aa, Ha^Fpa, Aa, Gs, Gd, Gd^Vhs, Gd, Hhd, Hhd, Hhd
Ms, Ms, Ms^Xm, Ms^Xm, Mm^Xm, Ms, Mm, Hh, Hh^Vhhr, Gs, Gs^Fmw, Gs, Ss, Ha^Fma, Ha^Fma, Ai, Mm, Ww, Hh^Fp, Ww, Ww, Ss, Ww, Gs^Fp, Ww, Gs^Fp, Ss, Ha^Fpa, Ss, Gs, Ss, Gs, Gs, Gd, Gd, Hhd, Hhd
Ms, Ms, Mm, Mm, Mm, Mm^Xm, Mm, Hh, Gs, Gs, Gs^Fmw, Gs^Fmw, Ss, Ss, Hh^Fdw, Mm, Mm^Vhh, Mm, Mm, Hh^Fp, Hh^Fp, Ww, Ss, Ww, Ss, Ww, Ww, Ss, Ss, Ss, Ss, Ss, Hh^Fp, Hhd^Fmw, Hhd^Fmw, Hhd^Fdw, Hhd^Fmw
Ms, Ms, Mm, Mm, Ha, Mm, Hh, Hh, Gs, Gs, Ss, Ss, Gs, Gs, Hh^Fdw, Mm, Mm, Mm, Hh, Hh, Gs, Gs, Gs, Ss^Vhs, Ss, Ss, Ss, Ss, Gs, Ss, Ss, Ss, Hh^Fp, Mm, Mm, Hhd^Fmw, Hhd
Ms, Ha, Ha, Ha, Ai, Ha, Dd, Dd, Gs, Ss, Gs, Hh, Gs, Ha, Ha, Hh, Hh, Hh, Gs, Gs, Gs^Fmw, Aa, Aa, Gs, Gs, Gs, Ss, Gs, Gs^Fp, Gg, Gd, Ss, Ss, Mm, Hh^Fp, Hhd^Fmw, Gd
Ms, Ha, Mm, Ai, Ww, Ww, Hh^Fmw, Gs, Gs, Ss, Gs, Hh, Gs, Ha, Hh, Gs, Gs, Gs, Aa, Gs, Gs^Fp, Gs^Fp, Gs, Gs, Ss, Ss^Bw\, Gs, Gs, Gs^Fp, Gg, Ss, Ss, Ss, Hh^Fp, Ss, Gs, Gs
Ms, Mm, Mm, Ai, Ss, Ww, Co, Gs, Gs, Ss, Ss, Gs, Aa, Gs, Hh^Fp, Gs, Gs, Gs, Gs, Gs, Gs, Gs, Ss, Gs, Ss, Ss, Gs, Hh^Fp, Hh^Fp, Gs, Gs, Ss, Ss, Gs, Ss, Ss, Ss
Ms, Mm, Mm, Mm, Ss, Co, 3 Ke, Co, Ss, Ss, Ss, Gs, Aa, Aa, Gs, Hh^Fp, Gs, Ss, Ss, Ss, Ss, Ss, Ss, Ss, Ss, Gs, Gs, Gs, Co, Gs, Gs, Ss, Ss, Ss, Ww, Ww, Ss
Ms, Mm, Mm, Mm, Gs, Co, Co, Co, Ss, Ss, Gs, Gs, Gs, Gs, Ss, Gs, Ss, Ss, Ss, Ss, Ss, Ss, Ww, Ww, Ss, Ss, Ss, Co, 4 Ke, Co, Ss, Gd, Ss, Ss, Ss, Ww, Ss
Ha^Fpa, Mm, Hh^Vhhr, Hh, Hh^Fdw, Hh, Gs, Gs, Ss, Ss, Ss, Ss, Ss, Ss, Ss, Ss, Ww^Ewl, Ss, Ss, Ss, Hh^Fp, Ss, Ss, Ww^Ewl, Ss, Ss, Ss, Co, Co, Co, Gd, Ss, Gd, Gd^Vhs, Ss, Ss, Ss
Ha^Fpa, Ha^Fpa, Ha^Fpa, Hh^Fdw, Hh^Fmw, Gs, Gs, Gs, Ss, Ss, Ww^Ewl, Ss, Ss, Ss^Vhs, Ss, Ss, Ss, Ss, Ss, Ss, Hh^Fp, Hh^Fp, Ss, Ss, Ss^Vhs, Ss, Gs, Gg, Gd, Gd, Gd, Gd, Gd, Gd, Ss, Ss, Ss
Ms, Ms, Ms, Hh^Fmw, Gs, Gs, Gs, Ss, Ss, Ww^Ewl, Ss, Ss, Hh^Fp, Ss, Hh^Fp, Hh^Fp, Hh^Fp, Hh^Fp, Hh^Fp, Hh^Fp, Ha^Fpa, Hh^Fp, Aa, Ss, Aa, Ss, Gs, Gd, Gd, Gd, Gd, Ss, Ss, Ss, Hh^Fp, Ss, Ss
Ms, Ms, Ms, Ha^Fda, Gs, Aa, Gs, Ss, Hh^Fp, Ss, Hh^Fp, Hh^Fp, Wwt, Hh^Fp, Wwt, Wwt, Ha^Fpa, Ha^Fpa, Mm, Ha^Fpa, Ms, Ha^Fpa, Ha^Fpa, Aa, Ha^Fpa, Aa, Aa, Gd, Hhd^Fmw, Hhd^Fmw, Gd, Hh^Fp, Hh^Fp, Hh^Fp, Mm, Hh^Fp, Hh^Fp
Ms, Ms, Ms, Ha^Fda, Gs, Aa, Aa, Gs, Gs, Hh^Fp, Ha^Fpa, Ha^Fpa, Ha^Fpa, Wwt, Wwt, Ha^Fpa, Ha^Fpa, Mm, Mm, Mm, Ha^Fda, Ha^Fda, Ha^Fma, Ha^Fpa, Aa, Aa, Gs, Gd, Hhd^Fmw, Gd, Hhd^Fmw, Hh^Fp, Hh^Fp, Mm, Mm, Mm, Mm