border_size=1
usage=map

Ms, Ms, Ms, Ms, Ai, Ai, Ha, Ha, Aa, Aa, Aa, Aa, Aa^Fpa, Ha^Fpa, Ha^Fpa, Ha^Fpa, Rp, Rp, Rp, Aa^Fpa, Ha^Fpa, Ms, Ms
Ms, Ms, Ha, Cha, Ai, Chw, Ha, Cha, Aa, Cha, Rp, Cha, Rp, Cha, Rp, Rp, Rp, Rp, Rp, Rp, Aa^Fpa, Ms, Ms
Ms, Ha^Vdya, Aa, Aa, Ai, Ai, Aa, Aa, Aa, Rp, Rp, Rp, Rp, Rp, Rp, Rp, Rp, Rp, Rp, Aa, Ha, Ms, Ms
Ha, Ha, Aa, Chw, Ai, Ai, Aa, Aa, Rp, Ch, Rp, Rp, Rp, Rp, Ch, Rp, Rp, Rp, Aa, Rp, Ha, Ms, Ms
Ha^Fpa, Aa, Aa, Ai, Ai, Aa, Aa, Rp, Rp, Rp, Rp, Rp, Rp, Ch, 2 Kha, Ch, Rp, Rp, Aa, Aa, Ha, Ha^Fpa, Ms
Ha^Fpa, Aa, Ai, Chw, Aa, Aa, Rp, Rp, Rp, 1 Ch, Rp, Rp, Rp, Ch, Ch, Ch, Rp, Rp, Rp, Cha, Ha, Ms, Ms
Aa, Aa, Ai, Ai, Aa, Aa, Aa, Rp, Rp, Rp, Rp, Rp, Rp, Rp, Rp, Rp, Rp, Rp, Aa, Aa, Ha, Ha^Vdyb, Ms
Aa, Aa, Ai, Chw, Aa, Aa, Rp, Rp, Rp, Ch, Rp, Rp, Rp, Rp, Rp, Rp, Rp, Rp, Rp, Cha, Ha^Fpa, Ms, Ms
Ai, Ai, Ai, Ai, Aa, Aa, Rp, Rp, Rp, Rp, Rp, Rp, Ch, Rp, Ch, Rp, Ch, Rp, Aa, Aa, Ha, Ha^Fpa, Ha^Fpa
Ai, Ai, Aa, Ch, Rp, Rp, Rp, Rp, Rp, Rp, Rp, Rp, Rp, Rp, Rp, Rp, Rp, Rp, Aa, Cha, Ha^Fpa, Ha^Fpa, Ms
Aa, Aa, Rp, Rp, Rp, Rp, Aa, Aa, Aa, Aa, Rp, Rp, Aa, Rp, Aa, Aa, Aa, Aa, Aa, Ha, Ha, Ha^Fpa, Ms
Rp, Rp, Rp, Rp, Aa, Aa, Aa, Aa, Aa, Aa, Aa, Aa, Aa, Aa, Aa, Aa, Aa, Aa, Aa, Cha, Aa, Ms, Ms
