border_size=1
usage=map

Ms, Ha^Fma, Gs, Xu, Uu^Es, Xu, Xu, Xu, Mm, Ai, Ms, Ms, Ms, Ms, Ms, Ms, Ms, Ms, Ms, Ms, Ms, Ms, Ms, Ms, Ha^Fda, Ms, Ms, Ms, Ms, Ms
Ms, Ha^Fma, Gs, Uu, Uu^Emf, Uu^Es, Uu^Es, Uu, Uh, Ha, Ms, Ms, Ms, Ms, Ms, Ms, Ms, Ms, Ms, Ms, Ms, Ms, Ms, Ha^Fda, Gs^Fdw, Ha^Fda, Ms, Ms, Ai, Ms
Hh^Fp, Hh^Fmw, Uu^Es, Uu, Co, Uu^Es, Uu, Uu^Es, Uh, Ms, Gs^Fp, Ms, Ha, Ha^Vaa, Ms, Ms, Ms, Ms, Gs, Ai, Ms, Ms^Vdye, Ms, Ha, Gs^Fmw, Ha^Fda, Ms, Ai, Ai, Ai
Uu, Uu^Es, Ur, Co, 2 Ke, Co, Ur, Uu, Hh^Fmw, Aa^Fpa, Gs, Ha, Aa, Ha, Ha^Fpa, Ms, Mm, Gs, Ms, Mm, Ms, Aa, Cea, Cea, Cea, Ms, Ha^Fpa, Ms, Ms, Ms
Ur, Ur, Ur, Co, Co, Co, Uu, Ur, Aa, Gs, Hh^Fmw, Gs, Ha^Fpa, Gs, Gs, Ha^Fpa, Hh^Fmw, Ai, Ha^Fpa, Hh, Hh, Ha, Cea, 3 Ke, Cea, Ha^Fda, Ha^Fda, Ms, Ha^Fpa, Ha^Fpa
Uu, Uu^Vu, Uu, Ur, Uu, Uu^Uf, Uu, Uu^Es, Hh^Fmw, Ha^Fma, Gs^Fmw, Ha^Fpa, Aa, Hh^Fmw, Ha^Fpa, Gs, Aa, Ai, Ai, Hh^Fmw, Ha^Fpa, Ha^Fpa, Ha^Fpa, Cea, Mm, Mm, Ms, Ms, Ha^Fpa, Ha^Fpa
Xu, Uu, Uh, Uu, Uu, Uu, Uh, Uh, Mm, Ms, Ms^Vaa, Ha^Fma, Gs^Fdw, Aa, Aa, Ha^Fpa, Hh^Fmw, Aa, Ha^Fpa, Gs, Ha^Fda, Ha^Fpa, Ha^Fpa, Ha^Fpa, Ms, Ha^Fma, Ha^Fda, Aa^Fma, Aa^Fma, Aa^Fma
Ms^Xm, Xu, Xu, Xu, Xu, Uh, Xu, Xu, Ms^Xm, Mm, Ms, Ms, Gs, Ha^Fpa, Aa, Ha, Mm, Ha^Fpa, Ms, Ai, Ai, Aa, Aa, Ha^Fpa, Hh, Ha^Vaa, Ai, Ai, Ai, Ai
Ms^Xm, Ms^Xm, Ms^Xm, Ms^Xm, Ms^Xm, Xu, Ms^Xm, Ms^Xm, Ms^Xm, Ms, Ha, Gs, Ms, Hh^Fmw, Hh^Fmw, Aa, Ms, Ha^Fpa, Aa, Ha^Fpa, Aa, Gs, Gs, Ha, Gs, Ai, Hh^Fmw, Ha^Fpa, Aa^Fma, Aa^Fma
Ms, Ms^Xm, Ms, Ms, Ms, Ms^Xm, Ms^Xm, Ms^Xm, Ms^Xm, Ms, Gs^Fp, Ai, Ha^Fpa, Ha^Fpa, Ha^Fpa, Ha^Fpa, Hh^Fmw, Ha^Fpa, Ha^Fpa, Aa, Aa, Ai, Ai, Ai, Ha^Fpa, Hh^Fmw, Mm, Ha^Fpa, Ha^Fpa, Gs
Ms, Ms, Ha^Fpa, Aa^Vhca, Ha^Fma, Ms, Mm, Ms^Xm, Ms^Xm, Ms^Xm, Ha^Fpa, Ai, Gs, Ms, Ha^Fpa, Ha^Fpa, Aa^Fpa, Ha^Fpa, Aa, Aa, Gs, Ai, Gs, Ha, Ha^Fpa, Ms, Ms, Ms, Ha^Fpa, Ms
Xuc, Hh^Fp, Ur, Ha^Fpa, Ur^Es, Ur^Es, Xu, Ms^Xm, Ms^Xm, Ms, Ha^Fpa, Ai, Ai, Ha^Vea, Hh^Fp, Ms, Aa^Fpa, Aa, Ai, Ai, Ms, Ha^Fma, Ha^Fma, Gs, Ha^Fpa, Ms, Ms, Ha^Fma, Ms, Ms
Xuc, Uu^Emf, Ur, Ur, Uu^Es, Uu^Es, Xuc, Ms^Xm, Ms^Xm, Ha^Fpa, Aa, Gs, Ms, Ms, Hh^Fp, Ha^Fpa, Ms, Ha^Fpa, Ai, Ha^Vdyd, Ms, Ms, Ha^Fpa, Gs, Ai, Mm, Mm, Ms, Ha^Vdy, Ms
Xuc, Xuc, Uu^Emf, Ur, Uu, Xuc, Xuc, Ms^Xm, Ms^Xm, Ms, Gs^Fmw, Gg, Ha^Fpa, Ha^Fpa, Ha^Fpa, Ms, Ha, Ha, Ai, Rd, Ha^Fpa, Ha^Fpa, Mm, Gs^Fp, Ai, Hh, Ha^Fma, Ms, Ha^Fma, Ha^Fma
Hh^Fp, Xuc, Aa, Gs^Efmy, Aa, Uh, Ms, Ms^Xm, Ms^Xm, Ms, Ha^Fpa, Ai, Hh^Fmw, Ms, Ms, Ms, Ha^Fma, Ai, Aa, Aa^Fma, Ha^Fpa, Ms, Ha, Aa^Fpa, Gs, Ha, Ha^Fma, Ha^Fma, Gs, Aa^Fma
Ms, Hh^Fp, Aa, Gs^Efmy, Aa, Ha^Fpa, Ms, Ms, Ms, Ms, Ha^Fpa, Ai, Gs, Ms, Ha, Ha^Fma, Ai, Ai, Aa, Gs^Fp, Gs^Fp, Hh, Ai, Ai, Ha^Fda, Gs, Aa^Fma, Gs, Aa^Fma, Gs
Ms, Ha^Fpa, Ha^Fpa, Gs^Efmy, Ha^Fpa, Ha^Fma, Ms, Ms, Ms^Xm, Ms^Vdy, Ms, Hh^Fp, Ha^Fpa, Gs, Ai, Ai, Aa, Aa^Fma, Ha, Aa^Fpa, Gs, Gs, Ha^Fda, Ha^Fpa, Ha^Fpa, Ha^Fpa, Ha^Fma, Aa, Ha^Fma, Ha^Fma
Ms, Ha^Fpa, Gs^Fp, Aa^Fpa, Ha^Fpa, Ms, Ms, Ms^Xm, Ms^Xm, Ms^Xm, Ms, Ms, Hh^Fmw, Aa, Aa, Aa^Fma, Aa^Fdw, Ha^Fma, Ha^Fpa, Ha^Fpa, Ha^Fpa, Ha^Fma, Mm, Gs^Fdw, Aa, Ha^Fda, Ha^Fma, Ha^Fma, Ms, Ha^Fma
Xuc, Ha^Fpa, Aa^Fpa, Gs, Uh, Xuc, Xuc, Ms^Xm, Ms^Xm, Ms^Xm, Mm, Ha^Fpa, Ha^Fpa, Aa, Gs, Aa, Ha^Fpa, Ha^Fpa, Ms, Ms, Ms, Ha, Ha^Vdyc, Gs^Fdw, Gs, Ha^Fma, Ha^Fma, Ms, Ha^Fma, Ms
Xuc, Xuc, Uu^Es, Ur, Uu, Uu^Uf, Xuc, Ms^Xm, Ms^Xm, Ms^Xm, Mm, Hh^Fp, Gs^Fdw, Aa, Ai, Aa^Fpa, Ha^Fda, Ha^Fma, Ms, Ms, Ha, Ha, Aa, Ha, Gs, Aa, Ai, Ha^Fma, Ai, Ms
Xuc, Uu^Vud, Uu, Ur, Ur, Uu, Uh, Xuc, Ms, Ms, Ha^Fpa, Hh^Fp, Gs, Ai, Aa^Fpa, Aa^Fma, Aa, Ha, Ha, Ha, Aa, Aa, Aa, Gs, Gs, Aa, Aa, Ai, Aa, Ha^Fma
Xuc, Xuc, Uu, Ur, Ur, Uu^Es, Uu^Es, Uu, Aa^Fma, Ha^Fpa, Aa, Aa^Fda, Ai, Ai, Gg, Aa^Fpa, Gg, Aa, Aa, Aa, Gg, Aa, Gs, Gs, Cea, Cea, Cea, Aa, Gs, Aa
Uu, Uu^Uf, Ur, Ur, Ur, Ur, Ur, Ur, Ha^Fpa, Gs, Gs^Fdw, Gs, Aa^Fma, Aa^Fda, Aa, Gg, Aa^Fpa, Gg, Gs^Efmy, Gs^Efmy, Gg, Aa, Aa, Aa, Cea, 1 Ke, Cea, Gs, Gs, Aa
Ur, Ur, Uu, Ur, Uu^Es, Uu^Emf, Uu^Es, Uu, Aa^Fpa, Aa^Fpa, Gs^Fmw, Ai, Ai, Aa^Vea, Aa^Fpa, Aa^Fpa, Ha^Fma, Aa, Aa^Fpa, Aa, Aa^Fpa, Ha^Fma, Ha^Fpa, Aa, Aa, Cea, Aa, Aa, Aa, Gs
Uu, Uu, Uh, Uu, Uh, Uu^Es, Xu, Xu, Ms, Ha^Fma, Ha^Fma, Aa^Fpa, Ai, Gs, Aa^Fpa, Ha^Fma, Ha^Fma, Ha^Fma, Ha^Fma, Ha^Fma, Ha^Fma, Ha^Fma, Ha^Fma, Ha^Fma, Ha^Fma, Ha^Fma, Ha^Fma, Aa, Ha^Fma, Aa
Xu, Xu, Xu, Xu, Xu, Xu, Ms, Ms, Ms, Ms, Ha^Fma, Aa^Fpa, Ai, Aa^Fpa, Ha^Fma, Ha^Fma, Ms, Ms, Ms, Ms, Ms, Ha^Fma, Ms, Ms, Ms, Ms, Ms, Ha^Fma, Ms, Ha^Fma
