border_size=1
usage=map

Aa, Aa, Aa^Fpa, Ha, Ha^Fpa, Ha, Ha^Fma, Ms, Ms, Ms, Ha, Ai, Aa, Aa^Fpa, Ha, Ms, Ha^Fpa, Ha^Fpa, Aa^Fpa, Ha^Fpa, Ha^Fpa, Ms, Ha^Fpa, Ms, Ha, Ms, Ms, Ha^Fpa, Aa, Aa, Gs, Aa
Aa, Aa, Aa, Aa^Fpa, Aa^Fma, Ha, Ha^Vdyb, Ha^Fma, Ha^Fpa, Aa^Fpa, Ai, Ai, Ai, Aa, Ha, Ha^Vdyc, Aa^Fpa, Aa, Gs^Fp, Aa^Fpa, Aa, Ha^Fpa, Aa^Fpa, Ha^Fpa, Aa^Voa, Ha^Fma, Ha^Fpa, Ha^Fpa, Aa, Gs, Aa, Aa
Aa, Gs, Gs, Aa, Cea, Aa, Gs, Ha^Fp, Aa, Aa, Aa^Fp, Aa^Fpa, Aa^Fma, Ai, Ai, Ha, Aa, Aa^Fp, Aa, Gs, Gs, Gs, Gs, Aa^Fpa, Aa, Aa^Fp, Aa, Aa, Gs, Gs, Aa, Aa^Fpa
Ha^Fpa, Aa, Aa, Cea, 1 Kea, Cea, Gs, Aa, Gs, Aa^Fma, Gs^Fp, Gs^Fp, Gs, Aa^Fma, Ai^Bw/, Aa, Aa^Fp, Aa, Ha, Gs^Fp, Ha^Fpa, Aa, Aa^Fma, Aa, Gs, Aa, Coa, Aa, Aa, Aa, Ha^Fpa, Ha^Fpa
Ha^Fpa, Ha^Fpa, Ha^Fma, Cea, Cea, Cea, Aa, Gs, Aa, Gs, Aa, Aa, Ha^Fpa, Aa, Ha^Fpa, Ai, Ha^Fpa, Ha^Fpa, Ms, Ha^Fpa, Ms, Ha^Fma, Aa, Aa, Gs, Co, 5 Kea, Coa, Aa^Fpa, Ha^Fpa, Ms, Ms
Ms, Ha^Fpa, Ha, Aa, Aa, Gs, Aa, Aa, Ha^Fpa, Ha^Vdye, Ha^Fpa, Ha^Fda, Ms, Ha, Ai, Ai, Ha^Fpa, Ha^Fpa, Ms, Ms, Ms, Ha^Fpa, Aa^Fpa, Gs, Gs, Coa, Coa, Coa, Ha^Fpa, Ha^Fma, Ms, Ms
Ms, Ms, Ha^Fpa, Aa^Fma, Gs, Gs, Ha, Ha^Fpa, Ms, Ms, Ha^Fma, Ha^Fpa, Ha, Ha^Fma, Ha^Fpa, Ai, Ha^Fpa, Ms, Ms, Ms^Xm, Ms, Ha^Fpa, Ha^Fpa, Aa, Gs, Aa, Aa^Fma, Aa^Fpa, Ha^Fpa, Ms, Ms^Vaa, Ms
Ha^Fpa, Ms, Ms, Ha^Fpa, Aa, Gs, Ha^Fpa, Ms, Ha^Fma, Ms, Ha^Fma, Ms, Ha, Ai, Ai, Ai, Ha^Fpa, Ms, Ms, Ms^Xm, Ms^Vaa, Ha^Fpa, Ha^Fpa, Ha^Fma, Aa^Fma, Gs, Aa, Aa^Fpa, Aa^Fpa, Ha^Fpa, Ms, Ms
Ha, Ha^Fpa, Ha^Fpa, Ha^Fpa, Aa^Fma, Aa, Aa^Fma, Ha^Fma, Ai, Ha, Aa, Ha^Fma, Gs, Ha, Ha^Vdyb, Ai, Ai, Ms, Ms, Ms^Xm, Ms, Ai, Ai, Ai, Ai, Aa^Fma, Aa, Aa^Fp, Aa^Fp, Ha^Fpa, Ha^Fpa, Ha^Fpa
Aa, Ha^Fpa, Aa^Fma, Aa^Fma, Gs, Gs, Aa, Aa, Ww, Aa, Gs, Aa, Gs^Es, Ha, Ha, Ha^Fpa, Ms, Ha, Ms, Ms^Xm, Ms, Ha^Fpa, Ha^Fpa, Ha^Fma, Aa^Fma, Ai, Ww^Bw|, Ww, Aa, Aa^Fp, Aa, Ha^Fpa
Ha, Aa, Aa, Aa^Fma, Gs, Aa, Ai, Ww^Bw\, Gs, Gs^Es, Ce, Cea, Ce, Hh^Es, Ms, Ms, Ms, Ms, Ms^Xm, Ms^Xm, Ms, Ha^Fpa, Ha^Fpa, Aa, Aa, Ww, Aa, Ww, Ai, Ai, Ai, Ai
Ha, Ha^Vdyd, Aa, Gs, Aa, Aa, Ai, Ww, Aa^Fma, Gs, Cea, 2 Ke, Cea, Hh, Ms, Ms, Ms^Xm, Ms^Xm, Ms, Ms, Ha^Fpa, Ha^Fpa, Aa, Aa, Aa^Fpa, Aa^Fma, Gs, Aa, Aa, Aa, Ha^Fpa, Ha^Fpa
Aa, Aa, Gs, Aa, Aa, Ai, Ai, Aa, Ha^Vdya, Aa^Fma, Hh, Ce, Hh, Ms, Ms, Ms^Xm, Ms, Ms, Ms, Aa^Fpa, Aa, Aa, Aa^Fpa, Gs^Fp, Gs, Aa, Gs, Aa^Fp, Aa^Fpa, Ha^Fda, Ms, Ms
Aa, Aa, Gs, Aa, Ha^Fpa, Aa, Ha^Fpa, Ha^Fpa, Ms, Ha, Ms, Mm, Mm, Mm, Mm, Ms, Ha, Ha^Vdyd, Ha^Fpa, Ha, Aa^Fpa, Aa^Fma, Aa^Fpa, Gs, Aa, Gs, Gs^Fp, Gs, Gs^Fp, Ha^Fda, Ms, Ms
Gs, Gs^Es, Gs^Es, Aa^Fma, Ha^Fpa, Ha^Fpa, Ms, Ms, Ha^Fda, Ms, Ms, Mm, Hh^Dr, Mm, Hh^Es, Hh^Es, Aa^Fpa, Ha^Fpa, Aa^Fpa, Aa, Aa, Gs, Aa, Aa, Gs, Aa^Fma, Aa^Fpa, Gs^Fp, Ha^Fpa, Ha, Ms, Ms
Aa, Gs, Aa, Ha^Fpa, Ms, Ms, Ms^Xm, Ms, Ms, Ms, Ha, Ha, Aa^Fma, Hh^Es, Aa^Fp, Aa^Fp, Gs^Fp, Aa^Fpa, Gs, Aa^Fma, Aa, Gs, Aa, Gs, Aa, Gs^Fp, Aa^Fpa, Ha^Fpa, Aa^Fpa, Ha^Voa, Ha^Fpa, Ms
Ha^Fpa, Aa, Aa, Ha^Fpa, Ms, Ms^Xm, Ms^Xm, Ms^Xm, Ms, Ms, Ha^Fma, Ai, Ai, Aa^Fma, Aa, Gs, Gs, Gs, Gs^Fp, Gs, Aa, Aa, Ha, Ha^Fpa, Ha^Fpa, Ha^Fma, Ha^Fma, Aa, Aa, Aa, Ha^Fpa, Ms
Ms, Ha^Fpa, Ha^Fpa, Ha^Fpa, Ms, Ms^Xm, Ms, Ms, Ha^Fpa, Ha, Aa^Fpa, Aa^Fpa, Aa, Ai, Aa, Aa, Gs, Gs^Fp, Ha^Fpa, Aa^Fpa, Ha^Fma, Ha, Ms, Ms, Ms, Ms, Ha^Fma, Aa^Fpa, Ha^Fma, Ha^Fpa, Ms, Ms
Ms, Ha^Fma, Ms, Ms, Ms, Ms, Ms, Ha^Fma, Aa^Fpa, Aa^Vaa, Aa, Gs, Aa^Fpa, Ai, Ai, Aa, Aa^Fpa, Aa^Fpa, Ha^Fma, Ms, Ms, Ms, Ha, Ms, Ha^Fda, Ha^Fda, Aa, Aa^Fpa, Ha^Fma, Ms, Ms, Ms
Ha^Fpa, Ha^Fma, Ha^Vdyc, Ha^Fma, Ha^Fpa, Ha^Fpa, Ha^Fpa, Ha^Fma, Aa^Fma, Aa^Fpa, Aa, Gs, Gs^Fp, Ha^Fpa, Aa^Fpa, Ai, Ai, Ha^Fpa, Ms, Ms^Voa, Ms, Ms, Ha^Fpa, Ha^Fda, Gs, Gs, Gs, Aa^Fpa, Aa^Fma, Ha^Fma, Ms, Ms
Aa^Fma, Ha^Fma, Aa^Fma, Aa^Fda, Aa^Fma, Aa^Fda, Ha^Fpa, Aa^Fma, Gs, Aa, Gs, Gs, Gs^Fp, Gs, Gs, Aa^Fpa, Ai, Ha^Fpa, Ha^Fpa, Ha, Ha^Fpa, Ms, Ha^Fpa, Aa, Gs, Gs, Gs, Gs, Aa^Fma, Ha^Fpa, Ms, Ms
Gs, Aa^Fma, Gs, Aa^Fma, Aa, Aa^Fma, Ha, Ha, Gs, Gs, Aa^Fda, Aa^Fma, Ha^Fpa, Gs^Fp, Aa^Fpa, Aa, Aa, Ai, Ai, Aa^Fma, Aa^Fma, Ha^Fpa, Aa, Aa, Gs, Gs, Aa, Coa, Ha^Fma, Ha^Fma, Ms, Ms
Aa, Gs, Gs, Gs, Gs, Gs, Co, Coa, Co, Gs, Aa^Fma, Aa^Fma, Ha^Fpa, Ha^Fpa, Ha^Fpa, Gs^Fp, Gs^Fp, Aa, Ww, Aa, Aa^Fma, Aa, Gs, Gs, Gs, Aa, Aa^Fma, Ha^Fma, Ha^Fpa, Ms, Ms, Ms
Aa^Fda, Aa, Aa, Aa, Aa, Gs, Coa, 4 Ke, Coa, Aa^Fma, Ha^Fpa, Ha^Fpa, Ms, Ms, Ms, Ha^Fpa, Gs^Fp, Ww, Gs, Gs, Gs, Gs, Gs, Aa, Coa, Coa, Coa, Aa^Fma, Aa, Ha^Fpa, Ha^Fma, Ms
Aa^Fda, Aa^Fda, Ha^Fma, Aa^Fma, Ha^Fma, Aa^Fma, Aa^Fma, Coa, Aa^Fma, Ha^Fma, Ha^Fpa, Ms, Ms, Ms, Ha^Fpa, Ha^Fpa, Aa, Ww, Gs, Gs, Gs, Coa, Gs, Aa, Co, 3 Ke, Co, Gs, Aa^Voa, Aa, Ha^Fpa, Ms
Ha^Fpa, Ha^Fpa, Ha^Fpa, Ha^Fpa, Ms, Ha^Fpa, Ha^Fpa, Ha^Fpa, Ha^Fpa, Ha^Fpa, Ha^Fpa, Ha^Fpa, Ms, Ms, Ms, Ha^Fma, Aa^Voa, Ai, Ww, Gs, Aa, Aa, Gs, Gs, Gs, Coa, Gs, Gs, Gs, Aa, Ha^Fpa, Ha^Fpa
Ms, Ms, Ha^Fma, Ha^Vaa, Ms, Ms, Ms, Ms, Ms, Ms, Ms, Ms, Ha^Fma, Ms, Ms, Ha^Fpa, Ha^Fpa, Aa, Ai, Aa, Aa^Fma, Aa^Fma, Aa, Gs, Aa, Aa, Gs, Gs, Aa, Aa, Aa^Fma, Ha^Fpa
Ms, Ms, Ms, Ms, Ms, Ms, Ms, Ms, Ms, Ms, Ms, Ms, Ms, Ms, Ms, Ms, Ms, Ha^Fpa, Ha^Fpa, Ai, Ha^Fpa, Ha^Fpa, Ha^Fpa, Aa^Fma, Ha^Fpa, Aa, Aa, Gs, Gs, Aa, Ha^Fpa, Ha^Fpa
