border_size=1
usage=map

Ms, Ms, Ha^Fma, Ha^Fma, Aa^Fma, Aa^Fma, Ha^Fpa, Ms, Ms, Ha^Fpa, Ha^Fpa, Aa^Fma, Aa^Fma, Ha^Fpa, Ha^Fpa, Aa^Fma, Aa, Aa, Gs, Ww, Ss, Ss, Ss, Gs, Ww, Gs, Aa, Aa, Ss, Ss, Gg, Gg, Re, Re
Ha^Fpa, Ha^Fpa, Aa^Fma, Aa^Fma, Gs, Gs, Aa^Fma, Ha^Fpa, Ha^Fma, Ha^Fpa, Ha^Fpa, Aa^Fma, Aa, Aa^Fda, Aa^Fma, Aa^Fma, Gs, Gs, Ww, Ww, Gs, Ss, Ss, Ss, Ww, Gs, Ss, Ss, Ss, Ss, Gg, Aa, Re, Gg
Ha^Fpa, Aa^Fma, Ce, Ce, Ce, Gs, Gs, Aa^Fma, Ha^Fpa, Ha^Voa, Aa^Fma, Aa^Fma, Aa, Aa, Aa, Aa, Gs, Ww, Gs, Gs, Aa, Aa, Ww, Ww, Ss, Gs, Gs, Ss, Ss, Gg, Aa, Re, Gg, Gg
Gs, Gs, Ce, 1 Ke, Ce, Gg, Gg, Gs, Ha^Fpa, Aa^Fma, Gs, Gs, Ha, Ha, Gs, Gg^Vo, Gs, Ww, Gs, Gs, Ww, Aa, Ww, Ss, Ss^Vhs, Gs, Ss, Ss, Ss, Gg, Re, Re, Gg, Ss
Aa^Fma, Gs, Gs, Ce, Gg, Gg, Gg, Aa^Fma, Aa^Fma, Ha^Fpa, Gs, Gs, Hh, Hh, Gs, Gs, Ww, Ww, Ww, Ww, Aa, Ai, Aa, Aa, Aa, Aa, Ss, Ss, Gg, Gg, Re, Gg, Ss, Ss
Ha^Fma, Aa^Fma, Aa^Fma, Gg, Aa, Gg, Gg, Gg, Aa^Fma, Aa^Fma, Gg, Hh^Es, Hh^Es, Gs, Ww, Ww, Dd, Dd, Dd, Dd, Dd, Aa, Ha, Ha, Aa, Ss, Ss, Ss, Gg, Re, Gg, Gg, Ss, Ss
Ha^Fma, Ha^Fma, Aa^Fma, Aa, Aa^Fma, Aa^Fma, Aa, Gg, Gg, Gg, Hh, Gg^Vo, Gs, Gs, Ww, Dd, Hd^Es, Hd^Es, Dd^Es, Dd^Es, Hd^Vo, Dd, Aa, Aa, Ss, Ss, Ss, Gg, Re, Re, Gg, Ss, Ss, Ss
Aa^Fma, Aa^Fma, Aa, Aa, Aa, Aa^Fma, Gs, Gs^Es, Gs, Gs^Es, Gs, Gs, Gs, Ww, Gs, Dd, Dd^Es, Dd, Co, Hd, Dd^Es, Dd, Gs, Ss, Ss, Ss, Aa, Gg, Re, Gg, Aa, Aa, Ss, Ss
Gg, Gg, Gg, Gg^Vo, Gs, Gs, Ww, Gs, Ww, Gs, Ww^Bw\, Ww, Ww, Ww, Gs, Hd, Dd, Ko, Dd, Dd, Gs^Es, Dd^Dr, Gs, Gs, Ss, Aa, Aa, Re, Gg, Gg, Ss^Vhs, Aa, Aa, Ss
Gg, Gs^Fmf, Gs^Fmf, Gg, Aa, Ww, Gs, Ww, Gs, Ww, Gs, Gs, Gs, Gs, Hh, Ha, Gs, Gs, Gs, Gs, Gs, Gs, Gs, Gg, Gg, Aa, Re, Re, Gg, Ss, Ss, Aa, Ss, Ss
Gg, Gs^Fmf, Gs^Fmf, Aa, Ww, Ww, Gs, Gs, Gg, Gs, Hh, Gs^Fdw, Hh^Fdw, Gs, Gs, Gs, Gs, Co, Gg, Co, Ss, Co, Gg, Co, Gg, Co, Re, Gg, Gg, Gg, Ss, Ss, Ss, Ss
Aa, Gg, Gg, Aa, Ww, Gs, Aa, Gg^Vo, Gg, Gs^Fmw, Hh, Hh, Gg, Gs, Gs, Co, Gs, Gg, Ss, Gg, Ss, Ss, Gg, Gg, Re, Re, Gg, Co, Gg, Ss, Gg, Ss, Gg, Ss
Aa, Aa, Gg, Ww, Aa, Aa, Aa, Aa, Aa, Gg, Gg, Gg, Gs, Co, Gs, Gs, Co, Co, Co, Ss, Gg, Gg, Re, Re, Co, Co, Co, Hh, Hh, Co, Hh, Gg, Gg, Ss
Ww, Ww, Ww, Ww, Aa, Ha, Ha, Ha, Hh^Es, Gg, Hh, Co, Hh, Hh, Hh, Hh, Co, 4 Ko, Co, Gg, Gg, Re, Gs, Gs, Co, 3 Ko, Co, Mm, Hh, Mm, Hh, Co, Ss, Ss
Gg, Gg, Gg, Gg, Hh, Ha, Hh, Ha, Hh^Es, Hh^Es, Hh, Hh, Mm, Mm^Vc, Ms, Mm, Hh^Vo, Co, Mm, Hh, Co, Re, Co, Gs, Hh^Vo, Co, Hh, Mm, Hh, Mm, Hh^Vo, Hh, Ss, Ss
Aa, Gg, Gs^Fp, Gs^Fp, Hh, Hh^Vo, Hh, Hh, Re^Gvs, Hh, Hh, Co, Hh, Hh, Aa, Hh, Hh, Mm, Hh, Hh, Hh, Re, Hh, Hh, Hh, Hh, Re, Hh^Vo, Hh, Hh, Hh, Co, Ss, Ss
Aa, Gg, Gs^Fp, Gs^Fp, Hh, Hh, Hh, Re^Gvs, Re^Gvs, Aa, Hh, Hh, Hh^Vo, Aa, Aa, Aa, Ha, Hh, Aa, Hh, Co, Co, Co, Ha, Aa, Re, Gs, Re, Gs, Re, Gs, Hh, Re, Ss
Aa, Aa, Gs^Fp, Gs^Fp, Re^Gvs, Re^Gvs, Re^Gvs, Re^Gvs, Re^Gvs, Hh, Hh, Co, Hh, Hh, Gs, Hh, Hh^Vo, Aa, Aa, Gs, Co, 2 Ko, Co, Aa, Aa, Aa, Gs, Gs, Hh^Vo, Gs, Gs, Co, Re, Re
Gg, Gg, Re^Gvs, Re^Gvs, Re^Gvs, Re^Gvs, Re^Gvs, Re^Gvs, Re^Gvs, Re^Gvs, Aa, Hh, Re, Gs, Gg^Vo, Re, Re, Re, Gs, Gs, Re, Co, Re, Gg, Gg, Gg, Gg^Vo, Gs, Hh, Hh^Vo, Re, Re, Ss, Ss
Re^Gvs, Re^Gvs, Re^Gvs, Re^Gvs, Re, Gg^Vo, Re^Gvs, Re^Gvs, Re, Re, Re, Co, Re, Re, Re, Re, Re, Re, Re, Co, Co, Re, Co, Co, Re, Gs, Re, Gs, Re, Re, Ds, Co, Ss, Ss
Re^Gvs, Re^Gvs, Re, Re, Re^Gvs, Re, Re, Re, Re^Gvs, Re^Gvs, Aa, Aa, Gg^Vo, Re, Dd, Dd, Dd, Re, Co, Co, Ds, Ds, Ds, Co, Co, Re, Re, Re, Co, Ds, Ds, Ds, Ss, Ss
Aa, Aa, Re^Gvs, Re^Gvs, Re^Gvs, Re^Gvs, Re^Gvs, Re^Gvs, Re^Gvs, Re^Gvs, Dd, Co, Co, Re, Co, Dd, Ds, Co, Co, Ds, Ww, Ww^Bw|, Ww, Ds, Co, Co, Co, Co, Dd, Dd, Ds, Ds, Ds, Ss
Re^Gvs, Re^Gvs, Re^Gvs, Re^Gvs, Aa, Re^Gvs, Aa, Gg^Vo, Dd, Dd, Ds, Dd, Ds, Co, Ds, Ds, Ww, Ds, Ds, Ds, Ww, Ww, Ww, Ds, Ds, Ds, Ds, Ds, Ds, Ds, Wo^Bw|, Ds, Ds, Dd
Re^Gvs, Re^Gvs, Dd, Dd, Ds, Dd, Ds, Dd, Ds, Ds, Ww, Ds, Ww, Ds, Ww, Ww, Wo, Ww, Ww, Ww, Ww, Ww, Ww, Ww, Ww, Ww, Ww, Ww, Ds, Wo, Wo, Wo, Ds, Dd
Dd, Dd, Ds, Ds, Ww, Ds, Ww, Ds, Ww, Ww, Wo, Ww, Wo, Ww, Wo, Wo, Wo, Wo, Wo, Wo, Ww, Ww, Wo, Wo, Wo, Wo, Wo, Ww, Ww, Wo, Ww, Wo, Ds, Ds
Dd, Dd, Ds, Ww, Wo, Ww, Wo, Ww, Wo, Wo, Wo, Wo, Ww, Wo, Ww, Wo, Ww, Wo, Ww, Wo, Ww, Ww, Ww, Wo, Wo, Ww, Ww, Wo, Wo, Ww, Ww, Ww, Ww, Wo
Ds, Ds, Wo, Wo, Wo, Wo, Wo, Wo, Wo, Wo, Wo, Wo, Ww, Ww, Wo, Wo, Ww, Ww, Wo, Wo, Wo, Ww, Wo, Ww, Wo, Ww, Wo, Wo, Wo, Ww, Wo, Wo, Wo, Wo
