border_size=1
usage=map

Ha^Fmw, Ha^Fmw, Aa^Fmw, Aa^Fmw, Aa^Fmw, Aa^Fmw, Aa^Fmw, Aa^Fmw, Gs^Fmw, Ww, Gs^Fmw, Gs^Fmw, Gs^Fmw, Aa^Fmw, Aa^Fmw, Aa^Fmw, Rd, Rd, Gs^Fmw, Gs^Fms, Gs^Fp, Aa, Aa^Fmw, Gs^Fp, Gs^Fp, Hh^Fp, Ha^Fmw, Ha^Fmw, Ha^Fmw, Ha^Fmw
Ha^Fmw, Ha^Fmw, Gs^Fp, Gs^Fp, Gg^Efm, Gs^Fp, Gll^Fmw, Gs^Fmw, Ww, Ww, Gs^Fmw, Gs^Fmw, Gg^Veyb, Aa, Aa, Aa^Fmw, Rd, Gs^Fmw, Gs^Fmw, Gs^Fmw, Gs^Fmw, Aa^Fmw, Gs^Fp, Gs^Fp, Gg^Veya, Gs^Fmw, Ha^Fmw, Ha^Fmw, Hhd^Fmw, Gll^Fmw
Aa^Fmw, Gs^Fmw, Gs^Fmw, Gg^Ve, Gs^Fms, Gg, Gg^Wm, Gg, Ww, Gg, Gg^Wm, Gs^Fmw, Aa, Aa^Fmw, Aa^Fmw, Rd, Gs^Fmw, Gs^Fmw, Ce, Ce, Ce, Gs^Fp, Gs^Fp, Gg^Efm, Gg^Efm, Gs^Fmw, Ha^Fmw, Hhd^Fmw, Ha^Fmw, Gll^Fmw
Aa^Fmw, Gs^Fmw, Gs^Fmw, Gs^Fmw, Gg^Fet, Gg, Gs^Fmw, Gs^Fmw, Ww, Gg, Gg, Gg, Gs^Fmw, Aa^Fmw, Rd, Rd, Gs^Fmw, Gs^Fmw, Ce, 1 Ke, Ce, Gs^Fp, Aa^Fmw, Gs^Fp, Gs^Fp, Gs^Fmw, Aa^Fmw, Ha^Fmw, Gs^Fp, Aa^Fmw
Gs^Fdw, Gs^Fmw, Aa, Aa, Aa, Gg^Fmw, Gs^Fmw, Gs^Fmw, Ww, Ww, Ww, Gs^Fmw, Gs^Fmw, Gs^Fmw, Rd, Gs^Fmw, Gs^Fmw, Gs^Fmw, Gs^Fmw, Ce, Gs^Fmw, Aa^Fmw, Aa^Fmw, Aa^Fmw, Gs^Fmw, Gs^Fmw, Hh^Fmw, Gs^Fp, Gs^Fp, Gs^Fp
Gs^Fmw, Gs^Fmw, Aa^Fmw, Aa^Fmw, Ce, Aa^Fmw, Gs^Fmw, Ww, Ss, Gs^Fmw, Gs^Fmw, Ww, Ww^Bw/, Rd, Gs^Fmw, Gs^Fmw, Gg^Veya, Aa^Fmw, Aa^Fmw, Gs^Fp, Gs^Fmw, Aa^Fmw, Aa^Fmw, Aa^Fmw, Gs^Fp, Gs^Fmw, Gs^Fp, Gs^Fp, Gg^Ve, Gs^Fp
Gs^Fmw, Aa^Fmw, Aa^Fmw, Ce, 5 Ke, Ce, Gs^Fmw, Ww, Ss, Gs^Fmw, Gs^Fmw, Rd, Gs^Fmw, Ww, Ww, Gs^Fmw, Gs^Fmw, Aa^Fmw, Aa^Fmw, Gs^Fmw, Gs^Fmw, Gs^Fmw, Gs^Fp, Gs^Fmw, Gs^Fmw, Gs^Fmw, Gg, Gg^Efmy, Gg^Efmy, Gs^Fmw
Gs^Fmw, Gg^Ve, Gs^Fdw, Ce, Ce, Ce, Ss, Ww, Gs^Fmw, Gs^Fmw, Rd, Rd, Gs^Fmw, Gs^Fmw, Gs^Fmw, Ww, Gs, Gs^Fmw, Gs, Gs, Gs, Gs^Fmw, Gg^Ve, Gs^Fms, Gs^Fmw, Gs^Fmw, Gs, Gg^Wm, Gs, Gs^Fp
Gs^Fmw, Gs^Fp, Gs^Fmw, Gs^Fmw, Gs^Fmw, Gs^Fmw, Ww, Ww, Gs^Fmw, Aa^Fmw, Rd, Gs^Fmw, Gg^Ve, Gs^Fmw, Gs^Fp, Ww, Ss, Gs, Ss, Ss, Ss, Gs^Ft, Gs^Ft, Gs^Fmw, Gs^Fmw, Gs^Fmw, Gs^Ft, Gs, Gs^Ft, Gs^Fp
Gs^Fmw, Gs^Fmw, Ss, Gs^Fmw, Ww, Ww, Ss, Gs^Fmw, Aa^Fmw, Rd, Gs^Fmw, Gs^Fms, Gg^Efm, Gg^Efm, Aa^Fmw, Gs^Fmw, Gs^Fmw, Ss, Ww, Ww, Ss, Gs^Ft, Gs^Ft, Gs^Ft, Gs^Ft, Gs^Ft, Gs^Ft, Gs^Ft, Ww, Ww
Gs^Fmw, Ss, Ww, Ww, Gs^Fmw, Gs^Fmw, Gs^Fms, Gs^Fmw, Rd, Rd, Gs^Fmw, Gs^Fp, Gs^Fmw, Aa, Aa^Fmw, Aa^Fmw, Gs^Fmw, Ss, Ss, Ss, Gs^Fp, Ss, Ss, Gs^Ft, Ww, Ww, Ww, Gs^Ft, Ww, Gs^Ft
Gs^Fmw, Ww, Ss, Gs^Fmw, Gs^Fmw, Gg^Ve, Gs^Fms, Gs^Fmw, Rd, Gs^Fmw, Aa^Fp, Aa^Fp, Gs^Fmw, Gs^Fmw, Gs^Fmw, Gg^Ve, Gs^Fms, Ss, Gs^Fmw, Ww, Gs^Ft, Gs^Fms, Gs^Ft, Ww, Gs^Ft, Gs^Ft, Ww, Ww, Gs^Ft, Gs^Ft
Ww, Ww, Cv, Gs^Fmw, Aa^Fp, Aa^Fp, Gg^Fet, Rd, Gg^Fet, Aa^Fp, Aa^Fp, Aa^Fmw, Cv, Gs^Fp, Gs^Fmw, Gs^Fmw, Ss, Gs^Ft, Gs^Fp, Ww, Ww, Gg^Ve, Ww, Ww, Ww, Ww, Ww, Gs^Ft, Gs^Ft, Gs^Ft
Ss, Ss, Gs^Fmw, Aa^Fp, Aa^Fp, Aa^Fp, Cv, Rd, Cv, Aa^Fp, Aa^Fp, Aa^Fp, Aa^Fp, Gs^Fp, Gs^Fp, Ss, Gs^Fp, Gg^Efm, Aa^Fp, Aa^Fp, Gs^Fp, Ww, Gs^Ft, Ww, Ds, Gs^Ft, Gs^Ft, Gs^Ft, Gs^Fp, Aa^Fp
Gs^Fmw, Gs^Fmw, Cv, Cv, Aa^Fetd, Cv, Gg^Efm, Gs, Gg^Efm, Cv, Aa^Fetd, Cv, Cv, Aa^Fp, Aa^Fp, Gs^Fp, Gs^Fp, Gg^Veyb, Gs^Fp, Aa^Fp, Gs^Fp, Gs^Ft, Gs^Ft, Ds, Gg^Efmy, Gg^Fet, Gg^Fet, Gs^Fp, Gs^Fp, Aa^Fp
Cv, Cv, Aa, Aa, Gg^Efm, Gg^Efm, Cv, Gs, Cv, Aa, Aa, Aa, Aa, Cv, Cv, Aa^Fp, Gs^Fmw, Gs^Fp, Gs^Fp, Gs^Fp, Cv, Gs^Fp, Gs^Fp, Gg^Fet, Gg^Efmy, Gg^Veya, Gs^Fp, Gs^Fp, Gs^Fp, Aa^Fp
Gg, Gg^Efm, Gg^Efmy, Aa^Fetd, Gg^Fet, Gg, Gs, Gs, Aa, Aa, Gs^Veyb, Aa^Fetd, Gs, Aa, Aa, Cv, Gs^Fmw, Gs^Fmw, Aa^Fp, Gs^Fp, Gs^Fmw, Gs^Fp, Gs^Fp, Gg^Fet, Gg^Efmy, Gg^Efm, Ce, Aa^Fp, Aa^Fp, Aa^Fp
Gg, Gg^Fet, Gg^Fet, Gg^Veya, Gg^Efm, Gs, Cv, Cv, Cv, Gs, Gs, Gs, Cv, Aa, Gg^Efm, Aa^Fetd, Cv, Aa^Fp, Aa^Fp, Gs^Fp, Gs^Fmw, Gs^Fmw, Gg^Efmy, Gg^Efmy, Gg^Efmy, Ce, 2 Ke, Ce, Gs^Fp, Aa^Fpa
Gg^Efmy, Gg^Veyb, Gg^Efm, Gg^Efm, Aa, Gs, Cv, 3 Kv, Cv, Gs, Gs, Cv, Gg^Efm, Cv, Gg^Efm, Aa, Cv, Aa^Fp, Aa^Fp, Aa^Fp, Gs^Fmw, Gs^Fmw, Gs^Fp, Gg^Efmy, Gs^Fmw, Ce, Ce, Ce, Aa^Fp, Aa^Fpa
Gg^Efm, Gg^Efm, Gg^Efm, Cv, Aa, Aa, Gs, Cv, Gs, Gs, Gg, Cv, Cv, Cv, Gg^Efm, Gg^Efm, Cv, Gs^Fmw, Aa^Fp, Aa^Fmw, Cv, Gs^Fp, Gs^Fp, Gs^Fp, Gs^Fmw, Gs^Fmw, Gs^Fp, Gs^Fp, Gg^Ve, Aa^Fpa
Gg^Efm, Cv, Aa, Aa, Aa, Cv, Gs, Gg, Gg^Efm, Cv, Gg^Efm, Gs, Gg^Efm, Gg^Efm, Aa, Aa^Fetd, Gs^Fmw, Gs^Fmw, Gs^Fp, Aa^Fmw, Aa^Fmw, Gs^Fmw, Gs^Fp, Gs^Fp, Gs^Fp, Gs^Fp, Aa^Fp, Aa^Fp, Gg^Efmy, Aa^Fpa
Cv, Aa, Aa, Cv, Aa, Aa, Cv, Gs, Cv, Gg^Efm, Aa, Cv, Gg^Efm, Gg^Efm, Cv, Cv, Gs^Fmw, Gs^Fmw, Gg^Efm, Aa^Fp, Aa^Fmw, Aa^Fmw, Gs^Fmw, Gg^Ve, Gs^Fp, Gs^Fp, Aa^Fp, Aa^Fp, Aa^Fp, Aa^Fpa
Aa^Fmw, Cv, Cv, Aa, Aa^Fetd, Aa, Gg^Efm, Gs, Aa, Aa, Aa^Fetd, Aa, Cv, Cv, Gg^Efm, Gg^Efm, Gg^Efmy, Gg^Efm, Gg^Efmy, Aa, Aa^Fmw, Aa^Fmw, Aa^Fmw, Gs^Fmw, Gs^Fp, Gs^Fp, Gs^Fp, Aa^Fp, Aa^Fp, Aa^Fp
Aa^Fdw, Aa^Fmw, Aa^Fmw, Cv, Aa^Fmw, Cv, Cv, Gs, Cv, Cv, Aa^Fmw, Cv, Gs^Fmw, Gs^Fmw, Gs^Fmw, Gg, Gg, Gg, Re^Gvs, Gg, Aa, Aa^Fmw, Aa^Fmw, Aa^Fmw, Gs^Fp, Gs^Fp, Gg^Fet, Aa^Fp, Ha^Fma, Aa^Fp
Aa^Fmw, Aa^Fmw, Aa^Fdw, Aa^Fmw, Aa^Fmw, Aa^Fmw, Gg^Fet, Rd, Gg^Fet, Aa^Fmw, Aa^Fmw, Gs^Fmw, Gs^Fp, Gs^Fp, Aa^Fdw, Gs^Fmw, Gg, Re^Gvs, Gg, Gg, Gs^Fmw, Aa^Fmw, Aa^Fp, Aa^Fp, Gg^Ve, Gs^Fp, Gs^Fmw, Aa^Fp, Ha^Fmw, Ha^Fma
Aa^Fdw, Aa^Fdw, Aa^Fp, Aa^Fmw, Aa^Fmw, Aa^Fmw, Cv, Rd, Cv, Aa^Fmw, Gs^Fp, Gs^Fdw, Gg^Ve, Aa^Fdw, Aa^Fdw, Gs^Fdw, Gs^Fmw, Gg, Gs^Fmw, Gs^Fmw, Aa^Fp, Gs^Fp, Gs^Fp, Aa^Fp, Gs^Fp, Gs^Fp, Gs^Fp, Aa^Fp, Aa^Fmw, Aa^Fma
Aa^Fmw, Aa^Fp, Gll^Fp, Gll^Fmw, Ce, Aa^Fmw, Aa, Rd, Gs, Aa^Fmw, Gs^Fp, Gs^Fms, Gs^Fp, Gg^Efm, Aa^Fdw, Gg^Fet, Gs^Fmw, Gg, Gg^Ve, Gs^Fmw, Aa^Fmw, Aa^Fp, Aa^Fmw, Gs^Fp, Gs^Fp, Aa^Fmw, Aa^Fp, Aa^Fmw, Gs^Fp, Aa^Fmw
Aa^Fmw, Gs^Fp, Gll^Fp, Ce, 4 Ke, Ce, Gs, Rd, Gs, Gll^Fmw, Gll^Fmw, Gg^Fet, Gs^Fp, Aa^Fdw, Gs^Fmw, Gs^Fp, Gg^Efmy, Gg^Efmy, Gs^Fdw, Gs^Fp, Ha^Fp, Ha^Fmw, Aa^Fmw, Aa^Fp, Aa^Fmw, Aa^Fmw, Aa^Fmw, Aa^Fp, Gs^Fp, Gs^Fp
Gs^Fp, Gs^Fp, Gs^Fp, Ce, Ce, Ce, Gs, Rd, Gs, Gll^Fmw, Gg, Gs^Fmw, Gg, Gg, Gg, Gg, Gg, Gs^Fmw, Gs^Fp, Aa^Fp, Aa^Fp, Aa^Fmw, Aa^Fp, Aa^Fmw, Aa^Fmw, Aa^Fmw, Aa^Fmw, Aa^Fp, Gg^Ve, Gs^Fp
Gs^Fdw, Gs^Fp, Gs^Fdw, Gs^Fdw, Gs, Gs, Rd, Rd, Gg, Gg, Gs^Fmw, Gg, Aa^Fmw, Gs^Fmw, Gg, Gs^Fdw, Gs^Fp, Gll^Fp, Aa^Fp, Gs^Fp, Gll^Fp, Gs^Fp, Gg^Ve, Aa^Fmw, Gs, Aa^Fmw, Gs^Fdw, Aa^Fmw, Aa^Fmw, Gs^Fp
Gg, Gg, Aa, Aa, Gs, Rd, Gs, Gg^Ve, Gs^Fdw, Gg^Fet, Aa, Aa, Aa, Gll^Fp, Gg^Ve, Gll^Fp, Gll^Fp, Aa^Fp, Aa^Fmw, Aa^Fp, Gll^Fp, Gs, Gs, Gs, Aa^Fp, Gg^Fet, Gs, Gs, Aa^Fmw, Gs^Fmw
Gll^Fp, Gs^Fdw, Gs^Fdw, Aa, Rd, Rd, Gll^Fdw, Gll^Fdw, Gll^Fdw, Gll^Fdw, Aa^Fdw, Aa^Fdw, Aa^Fdw, Gs^Fdw, Gll^Fp, Gll^Fp, Gll^Fp, Aa^Fp, Aa^Fmw, Aa^Fp, Gll^Fp, Gll^Fp, Gll^Fp, Gll^Fp, Gll^Fmw, Aa^Fp, Aa^Fmw, Aa^Fmw, Aa^Fpa, Aa^Fmw
